연도,시도,행정구역,학제,학교수,학생수,학생_남,학생_여,교직원수,다문화학생수,다문화_남,다문화_여
2021,경기,수원시,유치원,183,15710,8052,7658,1315,0,0,0
2021,경기,수원시,초등학교,99,65671,33885,31786,4073,2292,1156,1136
2021,경기,수원시,중학교,57,33954,17524,16430,2501,608,291,317
2021,경기,수원시,고등학교,44,35247,18734,16513,3497,277,109,168
2021,경기,수원시,  (일반고),31,26527,13785,12742,2525,155,49,106
2021,경기,수원시,  (특목고),4,1743,970,773,247,16,7,9
2021,경기,수원시,  (특성화고),8,6233,3235,2998,651,99,46,53
2021,경기,수원시,  (자율고),1,744,744,0,74,7,7,0
2021,경기,수원시,특수학교,3,456,317,139,186,0,0,0
2021,경기,성남시,유치원,122,8306,4196,4110,789,0,0,0
2021,경기,성남시,초등학교,72,45058,23198,21860,2893,1231,643,588
2021,경기,성남시,중학교,45,23835,12290,11545,1922,359,159,200
2021,경기,성남시,고등학교,36,25622,13025,12597,2550,213,110,103
2021,경기,성남시,  (일반고),27,19747,10464,9283,1899,110,53,57
2021,경기,성남시,  (특목고),2,1590,308,1282,107,8,3,5
2021,경기,성남시,  (특성화고),7,4285,2253,2032,544,95,54,41
2021,경기,성남시,특수학교,2,380,267,113,166,0,0,0
2021,경기,성남시,각종학교,2,480,86,394,35,4,0,4
2021,경기,부천시,유치원,123,8832,4418,4414,765,0,0,0
2021,경기,부천시,초등학교,64,37862,19356,18506,2415,2200,1138,1062
2021,경기,부천시,중학교,32,19687,10093,9594,1547,623,330,293
2021,경기,부천시,고등학교,28,18773,9455,9318,1960,219,106,113
2021,경기,부천시,  (일반고),23,15542,7903,7639,1567,149,69,80
2021,경기,부천시,  (특목고),1,691,128,563,46,0,0,0
2021,경기,부천시,  (특성화고),4,2540,1424,1116,347,70,37,33
2021,경기,부천시,특수학교,2,350,231,119,126,0,0,0
2021,경기,안양시,유치원,75,5171,2601,2570,479,0,0,0
2021,경기,안양시,초등학교,41,26687,13772,12915,1646,673,342,331
2021,경기,안양시,중학교,24,14955,7808,7147,1128,160,74,86
2021,경기,안양시,고등학교,21,16418,8321,8097,1580,101,41,60
2021,경기,안양시,  (일반고),13,11687,6304,5383,1062,31,14,17
2021,경기,안양시,  (특목고),3,1788,537,1251,138,10,2,8
2021,경기,안양시,  (특성화고),5,2943,1480,1463,380,60,25,35
2021,경기,안양시,특수학교,1,185,124,61,78,0,0,0
2021,경기,과천시,유치원,6,451,227,224,38,0,0,0
2021,경기,과천시,초등학교,4,3543,1845,1698,206,20,15,5
2021,경기,과천시,중학교,2,1819,960,859,134,3,2,1
2021,경기,과천시,고등학교,4,2126,1024,1102,224,6,5,1
2021,경기,과천시,  (일반고),3,1454,837,617,166,2,2,0
2021,경기,과천시,  (특목고),1,672,187,485,58,4,3,1
2021,경기,안산시,유치원,93,6567,3291,3276,547,0,0,0
2021,경기,안산시,초등학교,55,32594,16636,15958,2027,3762,1920,1842
2021,경기,안산시,중학교,30,17937,9267,8670,1363,1195,620,575
2021,경기,안산시,고등학교,24,19288,9949,9339,1940,582,263,319
2021,경기,안산시,  (일반고),17,13723,7034,6689,1383,306,144,162
2021,경기,안산시,  (특성화고),6,4527,2407,2120,478,274,117,157
2021,경기,안산시,  (자율고),1,1038,508,530,79,2,2,0
2021,경기,안산시,특수학교,2,287,197,90,104,0,0,0
2021,경기,용인시,유치원,163,13828,6959,6869,1062,0,0,0
2021,경기,용인시,초등학교,103,68048,34743,33305,4149,1131,583,548
2021,경기,용인시,중학교,50,33953,17489,16464,2440,315,147,168
2021,경기,용인시,고등학교,32,27414,14156,13258,2251,114,49,65
2021,경기,용인시,  (일반고),29,25482,13297,12185,2088,99,44,55
2021,경기,용인시,  (특성화고),2,834,479,355,98,8,2,6
2021,경기,용인시,  (자율고),1,1098,380,718,65,7,3,4
2021,경기,용인시,특수학교,2,282,185,97,107,0,0,0
2021,경기,용인시,각종학교,2,349,181,168,35,1,1,0
2021,경기,군포시,유치원,47,2543,1282,1261,220,0,0,0
2021,경기,군포시,초등학교,27,13915,7176,6739,938,575,317,258
2021,경기,군포시,중학교,12,7348,3809,3539,574,130,63,67
2021,경기,군포시,고등학교,8,6478,3438,3040,673,43,23,20
2021,경기,군포시,  (일반고),5,5175,2688,2487,467,28,15,13
2021,경기,군포시,  (특성화고),2,716,446,270,145,13,8,5
2021,경기,군포시,  (자율고),1,587,304,283,61,2,0,2
2021,경기,의왕시,유치원,22,1212,620,592,120,0,0,0
2021,경기,의왕시,초등학교,14,7294,3744,3550,489,189,93,96
2021,경기,의왕시,중학교,7,3463,1778,1685,288,34,11,23
2021,경기,의왕시,고등학교,5,3329,1593,1736,314,6,3,3
2021,경기,의왕시,  (일반고),3,2187,1142,1045,210,2,1,1
2021,경기,의왕시,  (특목고),1,585,156,429,45,2,1,1
2021,경기,의왕시,  (자율고),1,557,295,262,59,2,1,1
2021,경기,의왕시,특수학교,1,94,63,31,47,0,0,0
2021,경기,시흥시,유치원,77,6231,3122,3109,514,0,0,0
2021,경기,시흥시,초등학교,48,32306,16562,15744,1958,2360,1191,1169
2021,경기,시흥시,중학교,24,14913,7507,7406,1132,621,317,304
2021,경기,시흥시,고등학교,17,13169,6965,6204,1195,177,103,74
2021,경기,시흥시,  (일반고),13,10960,5406,5554,956,116,60,56
2021,경기,시흥시,  (특성화고),4,2209,1559,650,239,61,43,18
2021,경기,시흥시,각종학교,1,64,33,31,19,25,16,9
2021,경기,평택시,유치원,109,7241,3695,3546,610,0,0,0
2021,경기,평택시,초등학교,62,32911,16810,16101,2080,1661,824,837
2021,경기,평택시,중학교,25,15728,8115,7613,1097,448,237,211
2021,경기,평택시,고등학교,21,14670,7778,6892,1300,176,57,119
2021,경기,평택시,  (일반고),16,12074,6033,6041,1022,123,35,88
2021,경기,평택시,  (특목고),1,482,423,59,69,11,8,3
2021,경기,평택시,  (특성화고),4,2114,1322,792,209,42,14,28
2021,경기,평택시,특수학교,2,252,180,72,97,0,0,0
2021,경기,화성시,유치원,180,17417,8841,8576,1457,0,0,0
2021,경기,화성시,초등학교,101,68101,34688,33413,4111,1987,1010,977
2021,경기,화성시,중학교,43,30117,15283,14834,2032,529,268,261
2021,경기,화성시,고등학교,28,21128,10370,10758,1710,142,61,81
2021,경기,화성시,  (일반고),24,19792,9954,9838,1546,128,59,69
2021,경기,화성시,  (특목고),1,599,151,448,75,4,1,3
2021,경기,화성시,  (특성화고),3,737,265,472,89,10,1,9
2021,경기,화성시,특수학교,3,310,205,105,126,0,0,0
2021,경기,오산시,유치원,48,4634,2339,2295,399,0,0,0
2021,경기,오산시,초등학교,25,16340,8325,8015,1007,901,465,436
2021,경기,오산시,중학교,9,7579,3871,3708,498,195,100,95
2021,경기,오산시,고등학교,8,6654,3361,3293,554,56,32,24
2021,경기,오산시,  (일반고),7,5971,2944,3027,485,39,21,18
2021,경기,오산시,  (특성화고),1,683,417,266,69,17,11,6
2021,경기,오산시,특수학교,1,128,84,44,49,0,0,0
2021,경기,광명시,유치원,44,2717,1399,1318,264,0,0,0
2021,경기,광명시,초등학교,25,16124,8280,7844,1094,494,250,244
2021,경기,광명시,중학교,12,8855,4430,4425,684,136,63,73
2021,경기,광명시,고등학교,11,8075,4403,3672,814,55,27,28
2021,경기,광명시,  (일반고),9,7400,3930,3470,702,46,22,24
2021,경기,광명시,  (특성화고),2,675,473,202,112,9,5,4
2021,경기,광주시,유치원,43,2615,1327,1288,221,0,0,0
2021,경기,광주시,초등학교,31,20505,10503,10002,1238,856,436,420
2021,경기,광주시,중학교,11,9217,4658,4559,671,246,126,120
2021,경기,광주시,고등학교,8,6342,3000,3342,579,53,24,29
2021,경기,광주시,  (일반고),7,5962,3000,2962,542,49,24,25
2021,경기,광주시,  (특성화고),1,380,0,380,37,4,0,4
2021,경기,광주시,특수학교,4,328,233,95,146,0,0,0
2021,경기,하남시,유치원,35,2908,1481,1427,232,0,0,0
2021,경기,하남시,초등학교,23,18476,9411,9065,1059,292,150,142
2021,경기,하남시,중학교,12,7397,3736,3661,568,89,46,43
2021,경기,하남시,고등학교,10,5337,2711,2626,550,26,16,10
2021,경기,하남시,  (일반고),8,4466,2296,2170,436,18,9,9
2021,경기,하남시,  (특성화고),2,871,415,456,114,8,7,1
2021,경기,하남시,특수학교,1,125,90,35,53,0,0,0
2021,경기,하남시,고등공민학교,1,29,16,13,5,0,0,0
2021,경기,김포시,유치원,96,10287,5212,5075,773,0,0,0
2021,경기,김포시,초등학교,47,35537,18048,17489,2087,966,515,451
2021,경기,김포시,중학교,23,14577,7367,7210,1001,299,168,131
2021,경기,김포시,고등학교,14,10922,5565,5357,921,101,52,49
2021,경기,김포시,  (일반고),12,9754,4869,4885,803,90,43,47
2021,경기,김포시,  (특목고),1,541,204,337,48,1,0,1
2021,경기,김포시,  (특성화고),1,627,492,135,70,10,9,1
2021,경기,김포시,특수학교,1,219,150,69,88,0,0,0
2021,경기,이천시,유치원,47,2050,1022,1028,187,0,0,0
2021,경기,이천시,초등학교,31,12678,6551,6127,843,500,246,254
2021,경기,이천시,중학교,15,6426,3300,3126,522,153,73,80
2021,경기,이천시,고등학교,12,5929,3071,2858,620,80,25,55
2021,경기,이천시,  (일반고),10,5591,2953,2638,576,74,23,51
2021,경기,이천시,  (특성화고),2,338,118,220,44,6,2,4
2021,경기,이천시,특수학교,1,159,113,46,68,0,0,0
2021,경기,이천시,각종학교,1,0,0,0,12,0,0,0
2021,경기,안성시,유치원,47,2252,1138,1114,193,0,0,0
2021,경기,안성시,초등학교,34,10378,5303,5075,810,772,396,376
2021,경기,안성시,중학교,13,5277,2738,2539,424,194,93,101
2021,경기,안성시,고등학교,9,4449,2267,2182,417,63,32,31
2021,경기,안성시,  (일반고),6,3641,1740,1901,321,45,21,24
2021,경기,안성시,  (특성화고),3,808,527,281,96,18,11,7
2021,경기,안성시,특수학교,1,53,37,16,21,0,0,0
2021,경기,여주시,유치원,34,996,496,500,102,0,0,0
2021,경기,여주시,초등학교,23,5178,2685,2493,450,268,141,127
2021,경기,여주시,중학교,13,2657,1386,1271,291,100,36,64
2021,경기,여주시,고등학교,9,2842,1468,1374,321,51,25,26
2021,경기,여주시,  (일반고),7,2151,1074,1077,216,32,15,17
2021,경기,여주시,  (특성화고),2,691,394,297,105,19,10,9
2021,경기,양평군,유치원,25,525,278,247,64,0,0,0
2021,경기,양평군,초등학교,22,5036,2626,2410,430,257,139,118
2021,경기,양평군,중학교,12,2773,1410,1363,288,57,22,35
2021,경기,양평군,고등학교,8,2847,1483,1364,305,23,11,12
2021,경기,양평군,  (일반고),7,2681,1329,1352,275,21,9,12
2021,경기,양평군,  (특성화고),1,166,154,12,30,2,2,0
2021,경기,양평군,특수학교,1,76,40,36,40,0,0,0
2021,경기,고양시,유치원,167,12656,6417,6239,1111,0,0,0
2021,경기,고양시,초등학교,88,54368,27875,26493,3247,1305,647,658
2021,경기,고양시,중학교,43,28304,14360,13944,2104,351,184,167
2021,경기,고양시,고등학교,38,28304,14384,13920,2750,170,84,86
2021,경기,고양시,  (일반고),29,22169,11886,10283,2125,106,52,54
2021,경기,고양시,  (특목고),3,2137,513,1624,176,13,5,8
2021,경기,고양시,  (특성화고),5,3065,1479,1586,366,48,24,24
2021,경기,고양시,  (자율고),1,933,506,427,83,3,3,0
2021,경기,고양시,특수학교,4,531,373,158,195,0,0,0
2021,경기,고양시,각종학교,2,450,231,219,51,0,0,0
2021,경기,남양주시,유치원,111,9352,4710,4642,821,0,0,0
2021,경기,남양주시,초등학교,67,44845,23040,21805,2670,991,492,499
2021,경기,남양주시,중학교,35,22060,11344,10716,1587,295,135,160
2021,경기,남양주시,고등학교,21,18019,9258,8761,1605,101,58,43
2021,경기,남양주시,  (일반고),19,17069,8664,8405,1483,93,51,42
2021,경기,남양주시,  (특성화고),1,377,326,51,62,8,7,1
2021,경기,남양주시,  (자율고),1,573,268,305,60,0,0,0
2021,경기,남양주시,특수학교,1,199,125,74,73,0,0,0
2021,경기,구리시,유치원,29,1868,952,916,168,0,0,0
2021,경기,구리시,초등학교,16,9562,4949,4613,618,195,102,93
2021,경기,구리시,중학교,8,4671,2443,2228,336,46,28,18
2021,경기,구리시,고등학교,7,4596,2401,2195,436,34,13,21
2021,경기,구리시,  (일반고),7,4596,2401,2195,436,34,13,21
2021,경기,구리시,각종학교,1,678,358,320,45,0,0,0
2021,경기,의정부시,유치원,63,4395,2233,2162,408,0,0,0
2021,경기,의정부시,초등학교,34,22279,11421,10858,1337,628,331,297
2021,경기,의정부시,중학교,19,11683,6118,5565,893,159,100,59
2021,경기,의정부시,고등학교,16,11468,6141,5327,1175,79,45,34
2021,경기,의정부시,  (일반고),12,9324,4955,4369,896,42,27,15
2021,경기,의정부시,  (특목고),1,270,212,58,52,1,1,0
2021,경기,의정부시,  (특성화고),3,1874,974,900,227,36,17,19
2021,경기,의정부시,특수학교,2,226,158,68,86,0,0,0
2021,경기,파주시,유치원,95,6486,3303,3183,519,0,0,0
2021,경기,파주시,초등학교,58,29914,15226,14688,1882,908,459,449
2021,경기,파주시,중학교,27,14367,7313,7054,1050,217,117,100
2021,경기,파주시,고등학교,18,12254,6172,6082,1066,95,49,46
2021,경기,파주시,  (일반고),15,10267,5077,5190,898,79,36,43
2021,경기,파주시,  (특성화고),2,858,629,229,83,16,13,3
2021,경기,파주시,  (자율고),1,1129,466,663,85,0,0,0
2021,경기,파주시,특수학교,2,337,237,100,131,0,0,0
2021,경기,동두천시,유치원,18,418,228,190,49,0,0,0
2021,경기,동두천시,초등학교,11,4618,2349,2269,304,312,156,156
2021,경기,동두천시,중학교,6,2443,1219,1224,208,108,55,53
2021,경기,동두천시,고등학교,6,2613,1240,1373,278,59,27,32
2021,경기,동두천시,  (일반고),4,1556,763,793,159,39,17,22
2021,경기,동두천시,  (특목고),1,559,180,379,62,4,1,3
2021,경기,동두천시,  (특성화고),1,498,297,201,57,16,9,7
2021,경기,양주시,유치원,49,2764,1403,1361,255,0,0,0
2021,경기,양주시,초등학교,35,14037,7119,6918,945,539,281,258
2021,경기,양주시,중학교,11,6825,3413,3412,500,133,64,69
2021,경기,양주시,고등학교,8,5335,2734,2601,452,58,30,28
2021,경기,양주시,  (일반고),7,5036,2595,2441,420,52,27,25
2021,경기,양주시,  (특성화고),1,299,139,160,32,6,3,3
2021,경기,양주시,특수학교,1,170,121,49,61,0,0,0
2021,경기,양주시,각종학교,1,186,103,83,16,3,1,2
2021,경기,포천시,유치원,31,951,478,473,90,0,0,0
2021,경기,포천시,초등학교,31,6007,3076,2931,570,490,234,256
2021,경기,포천시,중학교,14,3288,1736,1552,346,149,70,79
2021,경기,포천시,고등학교,7,3186,1730,1456,352,73,35,38
2021,경기,포천시,  (일반고),6,3023,1600,1423,328,73,35,38
2021,경기,포천시,  (특성화고),1,163,130,33,24,0,0,0
2021,경기,가평군,유치원,14,239,121,118,31,0,0,0
2021,경기,가평군,초등학교,13,2345,1168,1177,234,278,133,145
2021,경기,가평군,중학교,6,1531,749,782,147,117,68,49
2021,경기,가평군,고등학교,5,1448,764,684,164,104,52,52
2021,경기,가평군,  (일반고),4,1132,640,492,142,94,46,48
2021,경기,가평군,  (특목고),1,316,124,192,22,10,6,4
2021,경기,가평군,각종학교,1,22,0,22,7,3,0,3
2021,경기,연천군,유치원,13,358,186,172,36,0,0,0
2021,경기,연천군,초등학교,13,1695,871,824,203,126,65,61
2021,경기,연천군,중학교,6,833,435,398,121,47,33,14
2021,경기,연천군,고등학교,2,742,401,341,112,16,9,7
2021,경기,연천군,  (일반고),2,742,401,341,112,16,9,7
2021,경기,연천군,각종학교,1,11,0,11,5,3,0,3
2022,경기,수원시,유치원,179,14097,7239,6858,1310,0,0,0
2022,경기,수원시,초등학교,99,65040,33536,31504,4084,2314,1169,1145
2022,경기,수원시,중학교,57,33483,17280,16203,2576,716,344,372
2022,경기,수원시,고등학교,44,34100,18000,16100,3448,334,140,194
2022,경기,수원시,  (일반고),32,26605,14037,12568,2548,204,79,125
2022,경기,수원시,  (특목고),4,1676,947,729,249,19,6,13
2022,경기,수원시,  (특성화고),8,5819,3016,2803,651,111,55,56
2022,경기,수원시,특수학교,3,456,316,140,193,0,0,0
2022,경기,성남시,유치원,122,7803,3967,3836,818,0,0,0
2022,경기,성남시,초등학교,73,44964,23074,21890,3013,1173,599,574
2022,경기,성남시,중학교,46,23534,12069,11465,1946,388,171,217
2022,경기,성남시,고등학교,36,24683,12446,12237,2536,240,118,122
2022,경기,성남시,  (일반고),27,19122,10055,9067,1886,127,63,64
2022,경기,성남시,  (특목고),2,1564,297,1267,109,13,5,8
2022,경기,성남시,  (특성화고),7,3997,2094,1903,541,100,50,50
2022,경기,성남시,특수학교,2,416,289,127,167,0,0,0
2022,경기,성남시,각종학교,2,470,84,386,39,11,4,7
2022,경기,부천시,유치원,121,8577,4307,4270,766,0,0,0
2022,경기,부천시,초등학교,64,36847,18813,18034,2380,2349,1182,1167
2022,경기,부천시,중학교,33,19233,9817,9416,1562,697,344,353
2022,경기,부천시,고등학교,28,17986,9058,8928,1884,327,165,162
2022,경기,부천시,  (일반고),23,15127,7723,7404,1505,218,104,114
2022,경기,부천시,  (특목고),1,667,128,539,44,1,0,1
2022,경기,부천시,  (특성화고),4,2192,1207,985,335,108,61,47
2022,경기,부천시,특수학교,2,351,225,126,124,0,0,0
2022,경기,안양시,유치원,74,5033,2537,2496,476,0,0,0
2022,경기,안양시,초등학교,41,26648,13667,12981,1627,689,330,359
2022,경기,안양시,중학교,24,14396,7541,6855,1147,196,98,98
2022,경기,안양시,고등학교,21,15615,7910,7705,1550,99,45,54
2022,경기,안양시,  (일반고),13,11301,6042,5259,1040,40,21,19
2022,경기,안양시,  (특목고),3,1730,546,1184,145,12,3,9
2022,경기,안양시,  (특성화고),5,2584,1322,1262,365,47,21,26
2022,경기,안양시,특수학교,1,199,142,57,84,0,0,0
2022,경기,과천시,유치원,6,466,242,224,36,0,0,0
2022,경기,과천시,초등학교,4,4231,2184,2047,243,23,12,11
2022,경기,과천시,중학교,2,2030,1051,979,148,6,5,1
2022,경기,과천시,고등학교,4,2096,1029,1067,228,4,3,1
2022,경기,과천시,  (일반고),3,1461,846,615,171,1,1,0
2022,경기,과천시,  (특목고),1,635,183,452,57,3,2,1
2022,경기,안산시,유치원,86,6258,3206,3052,555,0,0,0
2022,경기,안산시,초등학교,55,32026,16314,15712,2102,4100,2034,2066
2022,경기,안산시,중학교,30,17648,9156,8492,1402,1412,711,701
2022,경기,안산시,고등학교,24,18196,9347,8849,1882,728,335,393
2022,경기,안산시,  (일반고),17,13025,6609,6416,1333,390,186,204
2022,경기,안산시,  (특성화고),6,4177,2241,1936,467,336,147,189
2022,경기,안산시,  (자율고),1,994,497,497,82,2,2,0
2022,경기,안산시,특수학교,2,288,199,89,109,0,0,0
2022,경기,용인시,유치원,161,12515,6278,6237,1046,0,0,0
2022,경기,용인시,초등학교,103,67182,34269,32913,4205,1148,599,549
2022,경기,용인시,중학교,50,33928,17386,16542,2477,349,176,173
2022,경기,용인시,고등학교,32,27665,14413,13252,2289,166,71,95
2022,경기,용인시,  (일반고),29,25784,13560,12224,2121,149,66,83
2022,경기,용인시,  (특성화고),2,768,455,313,99,11,2,9
2022,경기,용인시,  (자율고),1,1113,398,715,69,6,3,3
2022,경기,용인시,특수학교,2,322,217,105,127,0,0,0
2022,경기,용인시,각종학교,2,355,191,164,36,1,1,0
2022,경기,군포시,유치원,45,2242,1145,1097,219,0,0,0
2022,경기,군포시,초등학교,27,13314,6865,6449,908,582,335,247
2022,경기,군포시,중학교,12,7106,3677,3429,601,171,95,76
2022,경기,군포시,고등학교,8,6256,3310,2946,649,58,28,30
2022,경기,군포시,  (일반고),5,5012,2623,2389,453,32,15,17
2022,경기,군포시,  (특성화고),2,665,391,274,140,21,10,11
2022,경기,군포시,  (자율고),1,579,296,283,56,5,3,2
2022,경기,의왕시,유치원,21,1117,587,530,114,0,0,0
2022,경기,의왕시,초등학교,14,7299,3753,3546,489,188,87,101
2022,경기,의왕시,중학교,7,3483,1779,1704,312,43,13,30
2022,경기,의왕시,고등학교,5,3336,1563,1773,315,21,10,11
2022,경기,의왕시,  (일반고),4,2768,1421,1347,272,14,7,7
2022,경기,의왕시,  (특목고),1,568,142,426,43,7,3,4
2022,경기,의왕시,특수학교,1,123,77,46,57,0,0,0
2022,경기,시흥시,유치원,80,6281,3075,3206,580,0,0,0
2022,경기,시흥시,초등학교,48,32896,16825,16071,2039,2575,1271,1304
2022,경기,시흥시,중학교,24,15103,7657,7446,1184,746,359,387
2022,경기,시흥시,고등학교,17,13173,6912,6261,1204,243,141,102
2022,경기,시흥시,  (일반고),13,11010,5421,5589,964,144,71,73
2022,경기,시흥시,  (특성화고),4,2163,1491,672,240,99,70,29
2022,경기,시흥시,각종학교,1,202,97,105,33,109,41,68
2022,경기,평택시,유치원,110,7537,3812,3725,712,0,0,0
2022,경기,평택시,초등학교,62,34122,17486,16636,2212,1885,924,961
2022,경기,평택시,중학교,25,16264,8322,7942,1176,493,247,246
2022,경기,평택시,고등학교,21,14743,7853,6890,1304,215,105,110
2022,경기,평택시,  (일반고),16,12235,6143,6092,1027,148,73,75
2022,경기,평택시,  (특목고),1,465,425,40,70,9,8,1
2022,경기,평택시,  (특성화고),4,2043,1285,758,207,58,24,34
2022,경기,평택시,특수학교,2,250,175,75,97,0,0,0
2022,경기,화성시,유치원,176,16352,8278,8074,1501,0,0,0
2022,경기,화성시,초등학교,101,69901,35607,34294,4275,2115,1089,1026
2022,경기,화성시,중학교,45,31546,16023,15523,2192,617,304,313
2022,경기,화성시,고등학교,29,22515,11013,11502,1815,187,74,113
2022,경기,화성시,  (일반고),25,21203,10597,10606,1655,174,70,104
2022,경기,화성시,  (특목고),1,588,146,442,67,3,1,2
2022,경기,화성시,  (특성화고),3,724,270,454,93,10,3,7
2022,경기,화성시,특수학교,3,322,217,105,127,0,0,0
2022,경기,오산시,유치원,46,4209,2158,2051,380,0,0,0
2022,경기,오산시,초등학교,25,16157,8266,7891,1034,925,490,435
2022,경기,오산시,중학교,9,7639,3966,3673,514,276,127,149
2022,경기,오산시,고등학교,8,6567,3252,3315,556,76,39,37
2022,경기,오산시,  (일반고),7,5937,2864,3073,486,64,29,35
2022,경기,오산시,  (특성화고),1,630,388,242,70,12,10,2
2022,경기,오산시,특수학교,1,131,89,42,51,0,0,0
2022,경기,광명시,유치원,43,2521,1287,1234,260,0,0,0
2022,경기,광명시,초등학교,25,15648,8010,7638,1092,446,240,206
2022,경기,광명시,중학교,12,8480,4299,4181,669,164,74,90
2022,경기,광명시,고등학교,11,7865,4204,3661,819,66,29,37
2022,경기,광명시,  (일반고),9,7261,3773,3488,707,54,21,33
2022,경기,광명시,  (특성화고),2,604,431,173,112,12,8,4
2022,경기,광주시,유치원,42,2436,1215,1221,221,0,0,0
2022,경기,광주시,초등학교,31,20931,10707,10224,1276,871,454,417
2022,경기,광주시,중학교,11,9271,4633,4638,700,280,148,132
2022,경기,광주시,고등학교,8,6521,3111,3410,589,69,30,39
2022,경기,광주시,  (일반고),7,6167,3111,3056,550,58,30,28
2022,경기,광주시,  (특성화고),1,354,0,354,39,11,0,11
2022,경기,광주시,특수학교,4,352,249,103,144,0,0,0
2022,경기,하남시,유치원,40,3511,1804,1707,309,0,0,0
2022,경기,하남시,초등학교,24,20999,10611,10388,1228,296,157,139
2022,경기,하남시,중학교,12,8406,4214,4192,625,97,39,58
2022,경기,하남시,고등학교,10,5884,2993,2891,603,39,20,19
2022,경기,하남시,  (일반고),8,5027,2582,2445,488,35,16,19
2022,경기,하남시,  (특성화고),2,857,411,446,115,4,4,0
2022,경기,하남시,특수학교,1,133,95,38,50,0,0,0
2022,경기,하남시,고등공민학교,1,35,23,12,5,0,0,0
2022,경기,김포시,유치원,97,9614,4857,4757,856,0,0,0
2022,경기,김포시,초등학교,47,36568,18499,18069,2139,1074,542,532
2022,경기,김포시,중학교,24,15201,7721,7480,1077,340,191,149
2022,경기,김포시,고등학교,14,11340,5804,5536,940,135,69,66
2022,경기,김포시,  (일반고),12,10289,5187,5102,827,121,60,61
2022,경기,김포시,  (특목고),1,499,188,311,49,4,0,4
2022,경기,김포시,  (특성화고),1,552,429,123,64,10,9,1
2022,경기,김포시,특수학교,1,220,151,69,89,0,0,0
2022,경기,이천시,유치원,45,1989,978,1011,176,0,0,0
2022,경기,이천시,초등학교,31,12783,6615,6168,884,525,267,258
2022,경기,이천시,중학교,15,6398,3252,3146,551,166,75,91
2022,경기,이천시,고등학교,12,5854,3038,2816,608,89,34,55
2022,경기,이천시,  (일반고),10,5527,2912,2615,564,83,31,52
2022,경기,이천시,  (특성화고),2,327,126,201,44,6,3,3
2022,경기,이천시,특수학교,1,156,111,45,69,0,0,0
2022,경기,이천시,각종학교,1,0,0,0,13,0,0,0
2022,경기,안성시,유치원,46,2025,1038,987,179,0,0,0
2022,경기,안성시,초등학교,34,10277,5244,5033,805,863,459,404
2022,경기,안성시,중학교,13,5320,2737,2583,435,236,120,116
2022,경기,안성시,고등학교,9,4378,2235,2143,416,95,48,47
2022,경기,안성시,  (일반고),6,3623,1746,1877,319,65,35,30
2022,경기,안성시,  (특성화고),3,755,489,266,97,30,13,17
2022,경기,안성시,특수학교,1,50,39,11,24,0,0,0
2022,경기,안성시,각종학교,1,30,6,24,18,0,0,0
2022,경기,여주시,유치원,34,944,467,477,103,0,0,0
2022,경기,여주시,초등학교,23,5052,2620,2432,453,271,135,136
2022,경기,여주시,중학교,13,2696,1441,1255,309,104,41,63
2022,경기,여주시,고등학교,9,2771,1431,1340,329,71,33,38
2022,경기,여주시,  (일반고),7,2111,1057,1054,220,48,24,24
2022,경기,여주시,  (특성화고),2,660,374,286,109,23,9,14
2022,경기,양평군,유치원,25,486,278,208,67,0,0,0
2022,경기,양평군,초등학교,22,5076,2637,2439,437,254,141,113
2022,경기,양평군,중학교,12,2774,1427,1347,301,71,24,47
2022,경기,양평군,고등학교,8,2840,1473,1367,306,31,17,14
2022,경기,양평군,  (일반고),7,2669,1316,1353,272,29,16,13
2022,경기,양평군,  (특성화고),1,171,157,14,34,2,1,1
2022,경기,양평군,특수학교,1,77,43,34,47,0,0,0
2022,경기,고양시,유치원,164,11361,5735,5626,1119,0,0,0
2022,경기,고양시,초등학교,88,53831,27516,26315,3382,1266,631,635
2022,경기,고양시,중학교,43,28097,14382,13715,2287,427,248,179
2022,경기,고양시,고등학교,38,27400,13784,13616,2750,223,91,132
2022,경기,고양시,  (일반고),30,22465,11848,10617,2210,149,63,86
2022,경기,고양시,  (특목고),3,2101,507,1594,175,14,3,11
2022,경기,고양시,  (특성화고),5,2834,1429,1405,365,60,25,35
2022,경기,고양시,특수학교,4,529,368,161,203,0,0,0
2022,경기,고양시,각종학교,2,471,233,238,53,0,0,0
2022,경기,남양주시,유치원,111,9137,4613,4524,859,0,0,0
2022,경기,남양주시,초등학교,68,45003,23114,21889,2772,993,502,491
2022,경기,남양주시,중학교,36,22383,11467,10916,1725,327,151,176
2022,경기,남양주시,고등학교,21,18395,9542,8853,1615,119,68,51
2022,경기,남양주시,  (일반고),20,18049,9248,8801,1560,112,62,50
2022,경기,남양주시,  (특성화고),1,346,294,52,55,7,6,1
2022,경기,남양주시,특수학교,1,203,135,68,77,0,0,0
2022,경기,구리시,유치원,28,1622,827,795,162,0,0,0
2022,경기,구리시,초등학교,16,9260,4771,4489,620,192,98,94
2022,경기,구리시,중학교,8,4576,2355,2221,365,70,41,29
2022,경기,구리시,고등학교,7,4305,2287,2018,421,28,14,14
2022,경기,구리시,  (일반고),7,4305,2287,2018,421,28,14,14
2022,경기,구리시,각종학교,1,672,357,315,44,0,0,0
2022,경기,의정부시,유치원,64,4213,2095,2118,412,0,0,0
2022,경기,의정부시,초등학교,34,22339,11473,10866,1404,623,318,305
2022,경기,의정부시,중학교,19,11614,6050,5564,921,197,120,77
2022,경기,의정부시,고등학교,16,11016,5907,5109,1152,83,40,43
2022,경기,의정부시,  (일반고),12,9066,4797,4269,882,52,25,27
2022,경기,의정부시,  (특목고),1,266,211,55,53,4,1,3
2022,경기,의정부시,  (특성화고),3,1684,899,785,217,27,14,13
2022,경기,의정부시,특수학교,2,226,158,68,92,0,0,0
2022,경기,파주시,유치원,91,6294,3231,3063,570,0,0,0
2022,경기,파주시,초등학교,60,30734,15542,15192,1993,892,463,429
2022,경기,파주시,중학교,28,14860,7580,7280,1116,308,163,145
2022,경기,파주시,고등학교,18,12287,6031,6256,1078,96,40,56
2022,경기,파주시,  (일반고),15,10304,4928,5376,910,84,33,51
2022,경기,파주시,  (특성화고),2,836,606,230,83,12,7,5
2022,경기,파주시,  (자율고),1,1147,497,650,85,0,0,0
2022,경기,파주시,특수학교,2,347,247,100,129,0,0,0
2022,경기,동두천시,유치원,16,352,189,163,45,0,0,0
2022,경기,동두천시,초등학교,11,4416,2282,2134,309,299,151,148
2022,경기,동두천시,중학교,6,2447,1205,1242,212,119,60,59
2022,경기,동두천시,고등학교,6,2457,1182,1275,272,65,22,43
2022,경기,동두천시,  (일반고),4,1558,761,797,160,46,13,33
2022,경기,동두천시,  (특목고),1,474,158,316,58,4,0,4
2022,경기,동두천시,  (특성화고),1,425,263,162,54,15,9,6
2022,경기,양주시,유치원,46,2670,1333,1337,252,0,0,0
2022,경기,양주시,초등학교,35,13987,7076,6911,967,510,277,233
2022,경기,양주시,중학교,11,6860,3420,3440,536,177,90,87
2022,경기,양주시,고등학교,8,5488,2831,2657,486,54,33,21
2022,경기,양주시,  (일반고),7,5213,2716,2497,455,50,31,19
2022,경기,양주시,  (특성화고),1,275,115,160,31,4,2,2
2022,경기,양주시,특수학교,1,179,130,49,68,0,0,0
2022,경기,양주시,각종학교,1,219,122,97,18,5,2,3
2022,경기,포천시,유치원,29,918,476,442,77,0,0,0
2022,경기,포천시,초등학교,29,5825,2998,2827,548,505,237,268
2022,경기,포천시,중학교,14,3222,1714,1508,351,176,81,95
2022,경기,포천시,고등학교,7,3027,1654,1373,357,91,46,45
2022,경기,포천시,  (일반고),6,2857,1516,1341,333,88,43,45
2022,경기,포천시,  (특성화고),1,170,138,32,24,3,3,0
2022,경기,가평군,유치원,14,243,127,116,32,0,0,0
2022,경기,가평군,초등학교,13,2311,1135,1176,234,257,123,134
2022,경기,가평군,중학교,6,1525,736,789,152,114,61,53
2022,경기,가평군,고등학교,5,1403,709,694,169,85,37,48
2022,경기,가평군,  (일반고),4,1099,584,515,145,77,34,43
2022,경기,가평군,  (특목고),1,304,125,179,24,8,3,5
2022,경기,가평군,각종학교,1,22,0,22,8,3,0,3
2022,경기,연천군,유치원,13,326,181,145,35,0,0,0
2022,경기,연천군,초등학교,13,1679,849,830,203,128,64,64
2022,경기,연천군,중학교,6,822,427,395,126,46,26,20
2022,경기,연천군,고등학교,2,733,397,336,112,24,14,10
2022,경기,연천군,  (일반고),2,733,397,336,112,24,14,10
2022,경기,연천군,각종학교,1,8,0,8,3,2,0,2
2015,경기,수원시,유치원,191,20400,10438,9962,1390,0,0,0
2015,경기,수원시,초등학교,97,69880,35881,33999,3957,1134,573,561
2015,경기,수원시,중학교,56,40322,21056,19266,2598,179,81,98
2015,경기,수원시,고등학교,43,47613,25066,22547,3508,127,57,70
2015,경기,수원시,  (일반고),30,37383,19693,17690,2558,73,33,40
2015,경기,수원시,  (특목고),4,1787,1066,721,238,9,7,2
2015,경기,수원시,  (특성화고),8,7570,3434,4136,641,45,17,28
2015,경기,수원시,  (자율고),1,873,873,0,71,0,0,0
2015,경기,수원시,특수학교,3,455,297,158,181,0,0,0
2015,경기,성남시,유치원,125,11510,5885,5625,874,0,0,0
2015,경기,성남시,초등학교,68,48568,25109,23459,2833,748,398,350
2015,경기,성남시,중학교,45,30063,15708,14355,2049,154,91,63
2015,경기,성남시,고등학교,35,35783,18418,17365,2789,85,43,42
2015,경기,성남시,  (일반고),26,28048,14932,13116,2116,54,32,22
2015,경기,성남시,  (특목고),2,1600,272,1328,110,8,1,7
2015,경기,성남시,  (특성화고),7,6135,3214,2921,563,23,10,13
2015,경기,성남시,특수학교,2,456,296,160,175,0,0,0
2015,경기,성남시,각종학교,1,424,53,371,26,0,0,0
2015,경기,부천시,유치원,123,11582,5770,5812,774,0,0,0
2015,경기,부천시,초등학교,62,42474,21789,20685,2460,950,507,443
2015,경기,부천시,중학교,32,25186,13118,12068,1637,196,85,111
2015,경기,부천시,고등학교,28,29468,15257,14211,2525,109,49,60
2015,경기,부천시,  (일반고),23,24664,12744,11920,2091,78,37,41
2015,경기,부천시,  (특목고),1,719,128,591,43,1,0,1
2015,경기,부천시,  (특성화고),4,4085,2385,1700,391,30,12,18
2015,경기,부천시,특수학교,2,334,228,106,126,0,0,0
2015,경기,안양시,유치원,86,7555,3844,3711,547,0,0,0
2015,경기,안양시,초등학교,41,31499,16304,15195,1754,377,189,188
2015,경기,안양시,중학교,24,19475,10172,9303,1277,75,40,35
2015,경기,안양시,고등학교,21,25205,12950,12255,1895,62,28,34
2015,경기,안양시,  (일반고),13,16846,8956,7890,1208,21,8,13
2015,경기,안양시,  (특목고),2,1740,459,1281,105,7,2,5
2015,경기,안양시,  (특성화고),6,6619,3535,3084,582,34,18,16
2015,경기,안양시,특수학교,1,248,176,72,85,0,0,0
2015,경기,과천시,유치원,8,684,357,327,46,0,0,0
2015,경기,과천시,초등학교,4,3665,1921,1744,206,21,11,10
2015,경기,과천시,중학교,2,2355,1259,1096,143,7,1,6
2015,경기,과천시,고등학교,4,3625,1664,1961,290,4,3,1
2015,경기,과천시,  (일반고),3,2805,1425,1380,228,2,2,0
2015,경기,과천시,  (특목고),1,820,239,581,62,2,1,1
2015,경기,안산시,유치원,99,9801,5006,4795,690,0,0,0
2015,경기,안산시,초등학교,54,40017,20559,19458,2257,1703,853,850
2015,경기,안산시,중학교,29,25470,13262,12208,1543,440,216,224
2015,경기,안산시,고등학교,24,30610,15814,14796,2169,180,80,100
2015,경기,안산시,  (일반고),17,22252,11607,10645,1578,97,35,62
2015,경기,안산시,  (특성화고),6,6644,3457,3187,496,82,44,38
2015,경기,안산시,  (자율고),1,1714,750,964,95,1,1,0
2015,경기,안산시,특수학교,2,267,175,92,92,0,0,0
2015,경기,용인시,유치원,169,18159,9207,8952,1202,0,0,0
2015,경기,용인시,초등학교,100,67783,34997,32786,3716,655,338,317
2015,경기,용인시,중학교,50,34393,17916,16477,2148,128,63,65
2015,경기,용인시,고등학교,30,31271,16256,15015,2108,51,19,32
2015,경기,용인시,  (일반고),27,28886,15135,13751,1952,40,14,26
2015,경기,용인시,  (특성화고),2,1283,691,592,99,7,4,3
2015,경기,용인시,  (자율고),1,1102,430,672,57,4,1,3
2015,경기,용인시,특수학교,1,149,100,49,49,0,0,0
2015,경기,용인시,각종학교,1,2,1,1,1,0,0,0
2015,경기,군포시,유치원,49,4396,2198,2198,290,0,0,0
2015,경기,군포시,초등학교,26,16802,8656,8146,1003,256,132,124
2015,경기,군포시,중학교,12,9360,4769,4591,588,46,18,28
2015,경기,군포시,고등학교,8,9621,5329,4292,722,16,5,11
2015,경기,군포시,  (일반고),5,7097,3632,3465,488,7,1,6
2015,경기,군포시,  (특성화고),2,1818,1339,479,181,9,4,5
2015,경기,군포시,  (자율고),1,706,358,348,53,0,0,0
2015,경기,의왕시,유치원,24,2020,1007,1013,148,0,0,0
2015,경기,의왕시,초등학교,13,7842,4033,3809,463,91,49,42
2015,경기,의왕시,중학교,7,4368,2208,2160,288,32,18,14
2015,경기,의왕시,고등학교,5,4215,1952,2263,332,16,6,10
2015,경기,의왕시,  (일반고),3,2816,1407,1409,220,10,4,6
2015,경기,의왕시,  (특목고),1,699,200,499,52,2,0,2
2015,경기,의왕시,  (자율고),1,700,345,355,60,4,2,2
2015,경기,시흥시,유치원,61,5290,2671,2619,344,0,0,0
2015,경기,시흥시,초등학교,37,24994,12794,12200,1453,863,430,433
2015,경기,시흥시,중학교,21,14756,7828,6928,952,165,92,73
2015,경기,시흥시,고등학교,15,15799,8422,7377,1072,54,31,23
2015,경기,시흥시,  (일반고),10,11819,5769,6050,784,36,17,19
2015,경기,시흥시,  (특성화고),4,3110,2311,799,218,15,12,3
2015,경기,시흥시,  (자율고),1,870,342,528,70,3,2,1
2015,경기,평택시,유치원,104,7631,3875,3756,556,0,0,0
2015,경기,평택시,초등학교,52,27812,14239,13573,1670,705,353,352
2015,경기,평택시,중학교,24,15786,8257,7529,993,140,53,87
2015,경기,평택시,고등학교,21,17828,9500,8328,1244,59,31,28
2015,경기,평택시,  (일반고),16,14835,7641,7194,978,36,18,18
2015,경기,평택시,  (특목고),1,486,439,47,65,5,4,1
2015,경기,평택시,  (특성화고),4,2507,1420,1087,201,18,9,9
2015,경기,평택시,특수학교,2,248,187,61,96,0,0,0
2015,경기,화성시,유치원,131,13381,6824,6557,827,0,0,0
2015,경기,화성시,초등학교,76,44842,22969,21873,2586,717,345,372
2015,경기,화성시,중학교,34,20355,10582,9773,1295,146,78,68
2015,경기,화성시,고등학교,21,16682,8142,8540,1128,53,21,32
2015,경기,화성시,  (일반고),17,15257,7708,7549,971,47,21,26
2015,경기,화성시,  (특목고),1,597,139,458,70,4,0,4
2015,경기,화성시,  (특성화고),3,828,295,533,87,2,0,2
2015,경기,화성시,특수학교,2,100,70,30,36,0,0,0
2015,경기,오산시,유치원,49,6259,3165,3094,404,0,0,0
2015,경기,오산시,초등학교,22,15598,8078,7520,884,319,167,152
2015,경기,오산시,중학교,9,7443,3828,3615,448,45,20,25
2015,경기,오산시,고등학교,8,7689,3960,3729,542,29,13,16
2015,경기,오산시,  (일반고),6,5974,3232,2742,402,22,11,11
2015,경기,오산시,  (특성화고),1,814,413,401,70,7,2,5
2015,경기,오산시,  (자율고),1,901,315,586,70,0,0,0
2015,경기,오산시,특수학교,1,136,100,36,49,0,0,0
2015,경기,광명시,유치원,51,4592,2329,2263,298,0,0,0
2015,경기,광명시,초등학교,24,20718,10656,10062,1145,334,161,173
2015,경기,광명시,중학교,11,11175,5806,5369,772,47,23,24
2015,경기,광명시,고등학교,11,11094,5833,5261,915,27,14,13
2015,경기,광명시,  (일반고),8,9222,4738,4484,740,26,14,12
2015,경기,광명시,  (특성화고),2,1161,726,435,107,1,0,1
2015,경기,광명시,  (자율고),1,711,369,342,68,0,0,0
2015,경기,광주시,유치원,39,2830,1460,1370,189,0,0,0
2015,경기,광주시,초등학교,25,16940,8621,8319,883,407,214,193
2015,경기,광주시,중학교,9,7848,4054,3794,461,62,29,33
2015,경기,광주시,고등학교,7,7404,3543,3861,512,43,19,24
2015,경기,광주시,  (일반고),6,6917,3543,3374,477,37,19,18
2015,경기,광주시,  (특성화고),1,487,0,487,35,6,0,6
2015,경기,광주시,특수학교,3,275,194,81,102,0,0,0
2015,경기,하남시,유치원,27,2106,1060,1046,138,0,0,0
2015,경기,하남시,초등학교,16,7861,4123,3738,455,156,79,77
2015,경기,하남시,중학교,8,4128,2170,1958,301,33,19,14
2015,경기,하남시,고등학교,7,4716,2377,2339,426,20,11,9
2015,경기,하남시,  (일반고),5,3426,1699,1727,295,10,4,6
2015,경기,하남시,  (특성화고),2,1290,678,612,131,10,7,3
2015,경기,하남시,특수학교,1,135,90,45,53,0,0,0
2015,경기,하남시,고등공민학교,1,47,29,18,5,0,0,0
2015,경기,김포시,유치원,81,8285,4245,4040,544,0,0,0
2015,경기,김포시,초등학교,41,22951,11808,11143,1318,463,247,216
2015,경기,김포시,중학교,22,10995,5648,5347,734,90,36,54
2015,경기,김포시,고등학교,13,10770,5569,5201,808,41,21,20
2015,경기,김포시,  (일반고),11,9358,4809,4549,700,30,14,16
2015,경기,김포시,  (특목고),1,624,234,390,46,2,0,2
2015,경기,김포시,  (특성화고),1,788,526,262,62,9,7,2
2015,경기,김포시,특수학교,1,126,85,41,49,0,0,0
2015,경기,이천시,유치원,52,2718,1430,1288,200,0,0,0
2015,경기,이천시,초등학교,31,12787,6674,6113,841,289,140,149
2015,경기,이천시,중학교,15,7299,3794,3505,493,121,58,63
2015,경기,이천시,고등학교,12,7954,4102,3852,623,79,34,45
2015,경기,이천시,  (일반고),10,7578,3941,3637,580,77,34,43
2015,경기,이천시,  (특성화고),2,376,161,215,43,2,0,2
2015,경기,이천시,각종학교,1,17,13,4,11,0,0,0
2015,경기,안성시,유치원,52,2784,1407,1377,216,0,0,0
2015,경기,안성시,초등학교,34,10861,5618,5243,790,318,145,173
2015,경기,안성시,중학교,13,5936,3133,2803,417,77,46,31
2015,경기,안성시,고등학교,9,5609,2809,2800,407,31,11,20
2015,경기,안성시,  (일반고),6,4581,2113,2468,309,23,6,17
2015,경기,안성시,  (특성화고),3,1028,696,332,98,8,5,3
2015,경기,안성시,특수학교,1,51,34,17,18,0,0,0
2015,경기,여주군,유치원,35,1471,751,720,111,0,0,0
2015,경기,여주군,초등학교,23,5699,2952,2747,442,157,75,82
2015,경기,여주군,중학교,13,3331,1721,1610,273,54,25,29
2015,경기,여주군,고등학교,9,3765,1826,1939,326,30,9,21
2015,경기,여주군,  (일반고),7,2929,1461,1468,225,22,7,15
2015,경기,여주군,  (특성화고),2,836,365,471,101,8,2,6
2015,경기,양평군,유치원,26,680,361,319,61,0,0,0
2015,경기,양평군,초등학교,22,4983,2587,2396,386,144,67,77
2015,경기,양평군,중학교,12,2774,1529,1245,238,23,12,11
2015,경기,양평군,고등학교,8,3626,1838,1788,295,17,5,12
2015,경기,양평군,  (일반고),7,3276,1549,1727,266,15,3,12
2015,경기,양평군,  (특성화고),1,350,289,61,29,2,2,0
2015,경기,양평군,특수학교,1,118,73,45,47,0,0,0
2015,경기,고양시,유치원,167,14703,7551,7152,1037,0,0,0
2015,경기,고양시,초등학교,82,56342,28873,27469,3099,623,316,307
2015,경기,고양시,중학교,41,34254,17806,16448,2175,107,57,50
2015,경기,고양시,고등학교,36,39632,20390,19242,2863,96,44,52
2015,경기,고양시,  (일반고),27,31679,16934,14745,2214,73,35,38
2015,경기,고양시,  (특목고),3,2287,635,1652,165,3,0,3
2015,경기,고양시,  (특성화고),5,4571,2201,2370,403,20,9,11
2015,경기,고양시,  (자율고),1,1095,620,475,81,0,0,0
2015,경기,고양시,특수학교,4,551,368,183,193,0,0,0
2015,경기,고양시,각종학교,2,360,182,178,37,4,0,4
2015,경기,남양주시,유치원,108,10710,5478,5232,729,0,0,0
2015,경기,남양주시,초등학교,59,41703,21520,20183,2288,579,280,299
2015,경기,남양주시,중학교,32,21287,10987,10300,1329,145,85,60
2015,경기,남양주시,고등학교,19,21154,10769,10385,1493,93,48,45
2015,경기,남양주시,  (일반고),16,18774,9426,9348,1299,82,39,43
2015,경기,남양주시,  (특성화고),1,778,680,98,65,7,7,0
2015,경기,남양주시,  (자율고),2,1602,663,939,129,4,2,2
2015,경기,남양주시,특수학교,1,210,145,65,77,0,0,0
2015,경기,구리시,유치원,31,2427,1235,1192,161,0,0,0
2015,경기,구리시,초등학교,15,10049,5250,4799,577,152,87,65
2015,경기,구리시,중학교,7,5971,3084,2887,371,52,24,28
2015,경기,구리시,고등학교,6,7069,3643,3426,504,46,29,17
2015,경기,구리시,  (일반고),6,7069,3643,3426,504,46,29,17
2015,경기,구리시,각종학교,1,811,423,388,42,0,0,0
2015,경기,의정부시,유치원,64,5473,2741,2732,409,0,0,0
2015,경기,의정부시,초등학교,32,22595,11646,10949,1334,262,148,114
2015,경기,의정부시,중학교,19,14461,7492,6969,944,63,24,39
2015,경기,의정부시,고등학교,16,16285,8962,7323,1231,54,27,27
2015,경기,의정부시,  (일반고),12,12856,6891,5965,926,36,16,20
2015,경기,의정부시,  (특목고),1,222,188,34,47,2,0,2
2015,경기,의정부시,  (특성화고),3,3207,1883,1324,258,16,11,5
2015,경기,의정부시,특수학교,2,233,162,71,79,0,0,0
2015,경기,파주시,유치원,99,7711,3923,3788,517,0,0,0
2015,경기,파주시,초등학교,57,27217,13988,13229,1610,544,279,265
2015,경기,파주시,중학교,24,13716,7153,6563,849,102,52,50
2015,경기,파주시,고등학교,17,12793,6403,6390,932,51,28,23
2015,경기,파주시,  (일반고),14,10640,5097,5543,773,35,15,20
2015,경기,파주시,  (특성화고),2,1042,807,235,79,16,13,3
2015,경기,파주시,  (자율고),1,1111,499,612,80,0,0,0
2015,경기,파주시,특수학교,2,313,202,111,125,0,0,0
2015,경기,동두천시,유치원,19,939,473,466,73,0,0,0
2015,경기,동두천시,초등학교,11,5358,2707,2651,332,171,87,84
2015,경기,동두천시,중학교,6,2895,1502,1393,187,47,17,30
2015,경기,동두천시,고등학교,6,3665,1714,1951,295,30,12,18
2015,경기,동두천시,  (일반고),4,2389,1197,1192,177,21,10,11
2015,경기,동두천시,  (특목고),1,623,213,410,63,5,1,4
2015,경기,동두천시,  (특성화고),1,653,304,349,55,4,1,3
2015,경기,양주시,유치원,47,2924,1461,1463,231,0,0,0
2015,경기,양주시,초등학교,32,13265,6827,6438,818,318,174,144
2015,경기,양주시,중학교,10,6579,3380,3199,400,58,24,34
2015,경기,양주시,고등학교,7,5711,2768,2943,382,18,8,10
2015,경기,양주시,  (일반고),5,4596,2286,2310,297,15,7,8
2015,경기,양주시,  (특성화고),1,350,118,232,29,2,0,2
2015,경기,양주시,  (자율고),1,765,364,401,56,1,1,0
2015,경기,양주시,각종학교,1,201,126,75,17,2,1,1
2015,경기,포천시,유치원,41,1427,727,700,118,0,0,0
2015,경기,포천시,초등학교,31,7757,4041,3716,583,313,160,153
2015,경기,포천시,중학교,14,4758,2547,2211,354,73,34,39
2015,경기,포천시,고등학교,7,4832,2520,2312,387,40,16,24
2015,경기,포천시,  (일반고),6,4648,2381,2267,361,40,16,24
2015,경기,포천시,  (특성화고),1,184,139,45,26,0,0,0
2015,경기,가평군,유치원,16,478,268,210,44,0,0,0
2015,경기,가평군,초등학교,13,2684,1421,1263,232,251,137,114
2015,경기,가평군,중학교,6,1892,953,939,138,137,70,67
2015,경기,가평군,고등학교,5,1910,1007,903,171,100,52,48
2015,경기,가평군,  (일반고),4,1620,874,746,149,90,45,45
2015,경기,가평군,  (특목고),1,290,133,157,22,10,7,3
2015,경기,연천군,유치원,14,367,187,180,34,0,0,0
2015,경기,연천군,초등학교,13,1813,966,847,194,100,63,37
2015,경기,연천군,중학교,6,1179,626,553,115,28,13,15
2015,경기,연천군,고등학교,2,1156,632,524,102,17,8,9
2015,경기,연천군,  (일반고),2,1156,632,524,102,17,8,9
2015,경기,연천군,각종학교,1,29,0,29,3,0,0,0
2016,경기,수원시,유치원,196,21223,10722,10501,1486,0,0,0
2016,경기,수원시,초등학교,97,68571,35113,33458,3998,1509,732,777
2016,경기,수원시,중학교,56,37123,19407,17716,2451,220,98,122
2016,경기,수원시,고등학교,44,46693,24606,22087,3585,132,60,72
2016,경기,수원시,  (일반고),31,36891,19367,17524,2634,69,27,42
2016,경기,수원시,  (특목고),4,1788,1065,723,241,10,3,7
2016,경기,수원시,  (특성화고),8,7137,3297,3840,641,52,29,23
2016,경기,수원시,  (자율고),1,877,877,0,69,1,1,0
2016,경기,수원시,특수학교,3,465,313,152,189,0,0,0
2016,경기,성남시,유치원,131,11509,5922,5587,913,0,0,0
2016,경기,성남시,초등학교,71,47233,24366,22867,2880,853,429,424
2016,경기,성남시,중학교,47,27501,14364,13137,1986,197,102,95
2016,경기,성남시,고등학교,36,34853,17899,16954,2778,100,54,46
2016,경기,성남시,  (일반고),27,27497,14535,12962,2110,60,34,26
2016,경기,성남시,  (특목고),2,1598,288,1310,108,9,3,6
2016,경기,성남시,  (특성화고),7,5758,3076,2682,560,31,17,14
2016,경기,성남시,특수학교,2,452,297,155,181,0,0,0
2016,경기,성남시,각종학교,2,467,73,394,42,4,2,2
2016,경기,부천시,유치원,124,11662,5831,5831,800,0,0,0
2016,경기,부천시,초등학교,62,41012,21010,20002,2448,1206,655,551
2016,경기,부천시,중학교,32,22827,11807,11020,1541,236,110,126
2016,경기,부천시,고등학교,28,27721,14431,13290,2464,177,83,94
2016,경기,부천시,  (일반고),23,23229,12025,11204,2036,121,51,70
2016,경기,부천시,  (특목고),1,723,130,593,45,2,0,2
2016,경기,부천시,  (특성화고),4,3769,2276,1493,383,54,32,22
2016,경기,부천시,특수학교,2,336,227,109,124,0,0,0
2016,경기,안양시,유치원,87,7316,3737,3579,558,0,0,0
2016,경기,안양시,초등학교,41,30053,15542,14511,1712,466,233,233
2016,경기,안양시,중학교,24,17793,9272,8521,1187,104,56,48
2016,경기,안양시,고등학교,21,24247,12515,11732,1853,73,34,39
2016,경기,안양시,  (일반고),13,16676,8828,7848,1175,17,5,12
2016,경기,안양시,  (특목고),2,1693,446,1247,105,10,2,8
2016,경기,안양시,  (특성화고),6,5878,3241,2637,573,46,27,19
2016,경기,안양시,특수학교,1,235,169,66,91,0,0,0
2016,경기,과천시,유치원,8,694,351,343,49,0,0,0
2016,경기,과천시,초등학교,4,3379,1763,1616,195,21,12,9
2016,경기,과천시,중학교,2,2133,1140,993,136,9,1,8
2016,경기,과천시,고등학교,4,3379,1533,1846,278,6,4,2
2016,경기,과천시,  (일반고),3,2602,1314,1288,218,3,3,0
2016,경기,과천시,  (특목고),1,777,219,558,60,3,1,2
2016,경기,안산시,유치원,100,9753,4925,4828,683,0,0,0
2016,경기,안산시,초등학교,54,38137,19605,18532,2217,2204,1124,1080
2016,경기,안산시,중학교,29,22450,11581,10869,1452,545,262,283
2016,경기,안산시,고등학교,24,29614,15319,14295,2179,271,123,148
2016,경기,안산시,  (일반고),17,21903,11445,10458,1607,125,51,74
2016,경기,안산시,  (특성화고),6,6247,3267,2980,486,146,72,74
2016,경기,안산시,  (자율고),1,1464,607,857,86,0,0,0
2016,경기,안산시,특수학교,2,275,177,98,102,0,0,0
2016,경기,용인시,유치원,170,18571,9387,9184,1208,0,0,0
2016,경기,용인시,초등학교,100,67099,34644,32455,3791,793,416,377
2016,경기,용인시,중학교,50,32279,16733,15546,2120,143,65,78
2016,경기,용인시,고등학교,31,31979,16738,15241,2200,72,32,40
2016,경기,용인시,  (일반고),28,29677,15661,14016,2045,59,25,34
2016,경기,용인시,  (특성화고),2,1199,630,569,97,8,4,4
2016,경기,용인시,  (자율고),1,1103,447,656,58,5,3,2
2016,경기,용인시,특수학교,1,147,96,51,51,0,0,0
2016,경기,용인시,각종학교,1,0,0,0,1,0,0,0
2016,경기,군포시,유치원,49,4241,2125,2116,297,0,0,0
2016,경기,군포시,초등학교,26,16234,8341,7893,965,325,158,167
2016,경기,군포시,중학교,12,8669,4396,4273,578,78,31,47
2016,경기,군포시,고등학교,8,9416,5219,4197,705,28,14,14
2016,경기,군포시,  (일반고),5,7139,3672,3467,485,11,4,7
2016,경기,군포시,  (특성화고),2,1560,1187,373,165,15,8,7
2016,경기,군포시,  (자율고),1,717,360,357,55,2,2,0
2016,경기,의왕시,유치원,24,2004,987,1017,147,0,0,0
2016,경기,의왕시,초등학교,13,7707,3986,3721,473,104,55,49
2016,경기,의왕시,중학교,7,3816,1971,1845,259,21,17,4
2016,경기,의왕시,고등학교,5,4189,1911,2278,319,15,8,7
2016,경기,의왕시,  (일반고),3,2844,1396,1448,215,9,4,5
2016,경기,의왕시,  (특목고),1,660,177,483,50,0,0,0
2016,경기,의왕시,  (자율고),1,685,338,347,54,6,4,2
2016,경기,시흥시,유치원,63,5273,2693,2580,352,0,0,0
2016,경기,시흥시,초등학교,38,24816,12652,12164,1490,1116,557,559
2016,경기,시흥시,중학교,22,13479,7107,6372,907,197,105,92
2016,경기,시흥시,고등학교,16,15710,8458,7252,1099,92,51,41
2016,경기,시흥시,  (일반고),11,11821,5864,5957,807,59,25,34
2016,경기,시흥시,  (특성화고),4,3009,2241,768,225,30,24,6
2016,경기,시흥시,  (자율고),1,880,353,527,67,3,2,1
2016,경기,평택시,유치원,107,7953,4068,3885,585,0,0,0
2016,경기,평택시,초등학교,54,28000,14323,13677,1762,848,412,436
2016,경기,평택시,중학교,24,14604,7552,7052,955,192,83,109
2016,경기,평택시,고등학교,21,17893,9559,8334,1257,83,37,46
2016,경기,평택시,  (일반고),16,14864,7631,7233,988,49,20,29
2016,경기,평택시,  (특목고),1,498,451,47,68,5,4,1
2016,경기,평택시,  (특성화고),4,2531,1477,1054,201,29,13,16
2016,경기,평택시,특수학교,2,253,182,71,99,0,0,0
2016,경기,화성시,유치원,139,15041,7672,7369,901,0,0,0
2016,경기,화성시,초등학교,80,49157,25104,24053,2873,951,460,491
2016,경기,화성시,중학교,34,20983,10821,10162,1367,196,94,102
2016,경기,화성시,고등학교,23,18060,8891,9169,1217,71,27,44
2016,경기,화성시,  (일반고),19,16623,8439,8184,1061,65,26,39
2016,경기,화성시,  (특목고),1,594,128,466,71,4,0,4
2016,경기,화성시,  (특성화고),3,843,324,519,85,2,1,1
2016,경기,화성시,특수학교,3,223,156,67,85,0,0,0
2016,경기,오산시,유치원,50,6673,3339,3334,413,0,0,0
2016,경기,오산시,초등학교,22,15381,7971,7410,905,464,234,230
2016,경기,오산시,중학교,9,6973,3586,3387,443,61,33,28
2016,경기,오산시,고등학교,8,7864,4022,3842,566,33,12,21
2016,경기,오산시,  (일반고),6,6149,3270,2879,421,21,9,12
2016,경기,오산시,  (특성화고),1,810,442,368,73,12,3,9
2016,경기,오산시,  (자율고),1,905,310,595,72,0,0,0
2016,경기,오산시,특수학교,1,122,92,30,48,0,0,0
2016,경기,광명시,유치원,51,4637,2354,2283,298,0,0,0
2016,경기,광명시,초등학교,24,20192,10398,9794,1158,485,212,273
2016,경기,광명시,중학교,11,10288,5381,4907,742,70,30,40
2016,경기,광명시,고등학교,11,10786,5714,5072,904,32,10,22
2016,경기,광명시,  (일반고),8,9030,4686,4344,732,24,8,16
2016,경기,광명시,  (특성화고),2,1077,671,406,108,6,1,5
2016,경기,광명시,  (자율고),1,679,357,322,64,2,1,1
2016,경기,광주시,유치원,38,2848,1463,1385,206,0,0,0
2016,경기,광주시,초등학교,25,17042,8676,8366,907,505,268,237
2016,경기,광주시,중학교,9,7501,3870,3631,455,67,30,37
2016,경기,광주시,고등학교,7,7571,3605,3966,541,47,21,26
2016,경기,광주시,  (일반고),6,7119,3605,3514,504,42,21,21
2016,경기,광주시,  (특성화고),1,452,0,452,37,5,0,5
2016,경기,광주시,특수학교,3,253,180,73,109,0,0,0
2016,경기,하남시,유치원,28,2302,1164,1138,142,0,0,0
2016,경기,하남시,초등학교,17,9254,4781,4473,528,189,99,90
2016,경기,하남시,중학교,10,4183,2170,2013,318,41,20,21
2016,경기,하남시,고등학교,9,4883,2446,2437,480,26,18,8
2016,경기,하남시,  (일반고),7,3670,1830,1840,355,8,4,4
2016,경기,하남시,  (특성화고),2,1213,616,597,125,18,14,4
2016,경기,하남시,특수학교,1,133,90,43,52,0,0,0
2016,경기,하남시,고등공민학교,1,35,25,10,7,0,0,0
2016,경기,김포시,유치원,84,8568,4350,4218,571,0,0,0
2016,경기,김포시,초등학교,41,23614,12111,11503,1396,505,273,232
2016,경기,김포시,중학교,22,10813,5560,5253,728,127,62,65
2016,경기,김포시,고등학교,13,10931,5677,5254,826,60,33,27
2016,경기,김포시,  (일반고),11,9552,4895,4657,716,53,28,25
2016,경기,김포시,  (특목고),1,602,221,381,44,1,0,1
2016,경기,김포시,  (특성화고),1,777,561,216,66,6,5,1
2016,경기,김포시,특수학교,1,152,101,51,60,0,0,0
2016,경기,이천시,유치원,53,2944,1520,1424,211,0,0,0
2016,경기,이천시,초등학교,31,12741,6651,6090,851,326,161,165
2016,경기,이천시,중학교,15,6752,3491,3261,478,115,51,64
2016,경기,이천시,고등학교,12,7948,4080,3868,624,91,37,54
2016,경기,이천시,  (일반고),10,7571,3932,3639,582,85,35,50
2016,경기,이천시,  (특성화고),2,377,148,229,42,6,2,4
2016,경기,이천시,특수학교,1,76,60,16,34,0,0,0
2016,경기,이천시,각종학교,1,0,0,0,11,0,0,0
2016,경기,안성시,유치원,51,2844,1421,1423,206,0,0,0
2016,경기,안성시,초등학교,34,10688,5533,5155,785,438,200,238
2016,경기,안성시,중학교,13,5515,2896,2619,395,109,57,52
2016,경기,안성시,고등학교,9,5549,2870,2679,403,74,42,32
2016,경기,안성시,  (일반고),6,4512,2143,2369,308,31,10,21
2016,경기,안성시,  (특성화고),3,1037,727,310,95,43,32,11
2016,경기,안성시,특수학교,1,54,36,18,21,0,0,0
2016,경기,여주시,유치원,35,1388,706,682,107,0,0,0
2016,경기,여주시,초등학교,23,5600,2918,2682,449,208,102,106
2016,경기,여주시,중학교,13,2966,1505,1461,256,52,17,35
2016,경기,여주시,고등학교,9,3747,1861,1886,323,30,15,15
2016,경기,여주시,  (일반고),7,2932,1477,1455,219,13,6,7
2016,경기,여주시,  (특성화고),2,815,384,431,104,17,9,8
2016,경기,양평군,유치원,27,696,365,331,64,0,0,0
2016,경기,양평군,초등학교,22,5029,2632,2397,389,180,81,99
2016,경기,양평군,중학교,12,2686,1477,1209,236,34,14,20
2016,경기,양평군,고등학교,8,3567,1797,1770,300,21,9,12
2016,경기,양평군,  (일반고),7,3228,1520,1708,271,19,7,12
2016,경기,양평군,  (특성화고),1,339,277,62,29,2,2,0
2016,경기,양평군,특수학교,1,110,68,42,45,0,0,0
2016,경기,고양시,유치원,174,15030,7732,7298,1083,0,0,0
2016,경기,고양시,초등학교,83,55090,28170,26920,3119,823,420,403
2016,경기,고양시,중학교,41,31582,16448,15134,2051,157,82,75
2016,경기,고양시,고등학교,36,39014,20168,18846,2888,122,57,65
2016,경기,고양시,  (일반고),27,31147,16783,14364,2245,95,44,51
2016,경기,고양시,  (특목고),3,2233,578,1655,162,1,0,1
2016,경기,고양시,  (특성화고),5,4553,2211,2342,402,26,13,13
2016,경기,고양시,  (자율고),1,1081,596,485,79,0,0,0
2016,경기,고양시,특수학교,4,526,363,163,200,0,0,0
2016,경기,고양시,각종학교,2,346,180,166,33,3,0,3
2016,경기,남양주시,유치원,109,11143,5634,5509,759,0,0,0
2016,경기,남양주시,초등학교,60,42143,21752,20391,2330,730,351,379
2016,경기,남양주시,중학교,32,20355,10466,9889,1307,179,100,79
2016,경기,남양주시,고등학교,20,21327,10880,10447,1533,97,57,40
2016,경기,남양주시,  (일반고),17,18968,9542,9426,1341,84,44,40
2016,경기,남양주시,  (특성화고),1,784,698,86,64,13,13,0
2016,경기,남양주시,  (자율고),2,1575,640,935,128,0,0,0
2016,경기,남양주시,특수학교,1,206,132,74,79,0,0,0
2016,경기,구리시,유치원,33,2567,1313,1254,182,0,0,0
2016,경기,구리시,초등학교,15,9699,5123,4576,568,159,88,71
2016,경기,구리시,중학교,7,5350,2752,2598,343,65,34,31
2016,경기,구리시,고등학교,6,6869,3554,3315,503,36,21,15
2016,경기,구리시,  (일반고),6,6869,3554,3315,503,36,21,15
2016,경기,구리시,각종학교,1,772,403,369,42,0,0,0
2016,경기,의정부시,유치원,67,5647,2842,2805,422,0,0,0
2016,경기,의정부시,초등학교,33,21968,11297,10671,1299,336,190,146
2016,경기,의정부시,중학교,19,13168,6793,6375,894,81,37,44
2016,경기,의정부시,고등학교,16,15771,8745,7026,1250,58,30,28
2016,경기,의정부시,  (일반고),12,12460,6715,5745,944,35,17,18
2016,경기,의정부시,  (특목고),1,253,206,47,46,1,0,1
2016,경기,의정부시,  (특성화고),3,3058,1824,1234,260,22,13,9
2016,경기,의정부시,특수학교,2,241,164,77,82,0,0,0
2016,경기,파주시,유치원,99,8016,3995,4021,523,0,0,0
2016,경기,파주시,초등학교,57,27390,14084,13306,1652,666,355,311
2016,경기,파주시,중학교,25,13145,6884,6261,862,118,62,56
2016,경기,파주시,고등학교,18,13598,6792,6806,1009,69,39,30
2016,경기,파주시,  (일반고),15,11557,5546,6011,855,51,25,26
2016,경기,파주시,  (특성화고),2,1010,797,213,77,18,14,4
2016,경기,파주시,  (자율고),1,1031,449,582,77,0,0,0
2016,경기,파주시,특수학교,2,325,212,113,122,0,0,0
2016,경기,동두천시,유치원,19,937,478,459,75,0,0,0
2016,경기,동두천시,초등학교,11,5247,2621,2626,333,199,93,106
2016,경기,동두천시,중학교,6,2741,1448,1293,196,58,33,25
2016,경기,동두천시,고등학교,6,3558,1699,1859,286,36,13,23
2016,경기,동두천시,  (일반고),4,2292,1156,1136,171,20,8,12
2016,경기,동두천시,  (특목고),1,619,207,412,60,5,1,4
2016,경기,동두천시,  (특성화고),1,647,336,311,55,11,4,7
2016,경기,양주시,유치원,47,2895,1484,1411,235,0,0,0
2016,경기,양주시,초등학교,32,13048,6772,6276,833,395,210,185
2016,경기,양주시,중학교,10,6295,3173,3122,389,68,29,39
2016,경기,양주시,고등학교,7,5860,2842,3018,402,24,12,12
2016,경기,양주시,  (일반고),5,4760,2402,2358,313,20,10,10
2016,경기,양주시,  (특성화고),1,361,119,242,30,2,0,2
2016,경기,양주시,  (자율고),1,739,321,418,59,2,2,0
2016,경기,양주시,각종학교,1,166,109,57,16,1,0,1
2016,경기,포천시,유치원,41,1399,681,718,114,0,0,0
2016,경기,포천시,초등학교,31,7384,3871,3513,569,367,180,187
2016,경기,포천시,중학교,14,4351,2318,2033,345,94,45,49
2016,경기,포천시,고등학교,7,4712,2506,2206,367,39,11,28
2016,경기,포천시,  (일반고),6,4538,2366,2172,342,39,11,28
2016,경기,포천시,  (특성화고),1,174,140,34,25,0,0,0
2016,경기,가평군,유치원,16,425,230,195,35,0,0,0
2016,경기,가평군,초등학교,13,2668,1392,1276,238,278,140,138
2016,경기,가평군,중학교,6,1737,932,805,145,145,67,78
2016,경기,가평군,고등학교,5,1862,969,893,173,119,62,57
2016,경기,가평군,  (일반고),4,1567,833,734,147,106,57,49
2016,경기,가평군,  (특목고),1,295,136,159,26,13,5,8
2016,경기,연천군,유치원,14,419,220,199,35,0,0,0
2016,경기,연천군,초등학교,13,1804,947,857,195,109,66,43
2016,경기,연천군,중학교,6,1024,570,454,109,26,16,10
2016,경기,연천군,고등학교,2,1148,636,512,99,17,7,10
2016,경기,연천군,  (일반고),2,1148,636,512,99,17,7,10
2016,경기,연천군,각종학교,1,29,0,29,4,1,0,1
2017,경기,수원시,유치원,197,20801,10599,10202,1465,0,0,0
2017,경기,수원시,초등학교,97,68095,34899,33196,3985,1644,838,806
2017,경기,수원시,중학교,56,35233,18271,16962,2407,281,131,150
2017,경기,수원시,고등학교,44,44638,23557,21081,3578,148,65,83
2017,경기,수원시,  (일반고),31,35028,18401,16627,2649,72,26,46
2017,경기,수원시,  (특목고),4,1786,1038,748,242,8,5,3
2017,경기,수원시,  (특성화고),8,6956,3250,3706,615,63,29,34
2017,경기,수원시,  (자율고),1,868,868,0,72,5,5,0
2017,경기,수원시,특수학교,3,462,322,140,194,0,0,0
2017,경기,성남시,유치원,131,11118,5647,5471,918,0,0,0
2017,경기,성남시,초등학교,72,47213,24211,23002,2912,955,490,465
2017,경기,성남시,중학교,45,26094,13589,12505,1958,218,114,104
2017,경기,성남시,고등학교,36,32903,16816,16087,2708,124,65,59
2017,경기,성남시,  (일반고),27,25792,13606,12186,2041,73,41,32
2017,경기,성남시,  (특목고),2,1606,294,1312,108,9,3,6
2017,경기,성남시,  (특성화고),7,5505,2916,2589,559,42,21,21
2017,경기,성남시,특수학교,2,434,280,154,179,0,0,0
2017,경기,성남시,각종학교,2,486,76,410,41,31,11,20
2017,경기,부천시,유치원,126,11651,5862,5789,821,0,0,0
2017,경기,부천시,초등학교,64,40820,20958,19862,2504,1316,708,608
2017,경기,부천시,중학교,33,21369,11005,10364,1553,253,129,124
2017,경기,부천시,고등학교,28,25767,13387,12380,2315,170,79,91
2017,경기,부천시,  (일반고),23,21308,11053,10255,1889,107,40,67
2017,경기,부천시,  (특목고),1,730,129,601,45,1,1,0
2017,경기,부천시,  (특성화고),4,3729,2205,1524,381,62,38,24
2017,경기,부천시,특수학교,2,338,231,107,123,0,0,0
2017,경기,안양시,유치원,83,7048,3593,3455,535,0,0,0
2017,경기,안양시,초등학교,41,29890,15445,14445,1699,525,263,262
2017,경기,안양시,중학교,24,16563,8660,7903,1157,95,49,46
2017,경기,안양시,고등학교,21,22546,11632,10914,1794,77,35,42
2017,경기,안양시,  (일반고),13,15644,8297,7347,1145,26,9,17
2017,경기,안양시,  (특목고),2,1647,427,1220,110,7,1,6
2017,경기,안양시,  (특성화고),6,5255,2908,2347,539,44,25,19
2017,경기,안양시,특수학교,1,225,157,68,89,0,0,0
2017,경기,과천시,유치원,8,498,252,246,42,0,0,0
2017,경기,과천시,초등학교,4,2973,1570,1403,175,18,12,6
2017,경기,과천시,중학교,2,1938,1038,900,133,7,2,5
2017,경기,과천시,고등학교,4,3088,1424,1664,272,5,3,2
2017,경기,과천시,  (일반고),3,2334,1222,1112,212,2,2,0
2017,경기,과천시,  (특목고),1,754,202,552,60,3,1,2
2017,경기,안산시,유치원,98,9045,4504,4541,695,0,0,0
2017,경기,안산시,초등학교,54,36926,18975,17951,2160,2507,1307,1200
2017,경기,안산시,중학교,29,20706,10683,10023,1440,587,278,309
2017,경기,안산시,고등학교,24,27916,14437,13479,2136,356,166,190
2017,경기,안산시,  (일반고),17,20809,10854,9955,1579,180,77,103
2017,경기,안산시,  (특성화고),6,5891,3112,2779,478,175,89,86
2017,경기,안산시,  (자율고),1,1216,471,745,79,1,0,1
2017,경기,안산시,특수학교,2,284,194,90,102,0,0,0
2017,경기,용인시,유치원,171,18118,9139,8979,1183,0,0,0
2017,경기,용인시,초등학교,100,67328,34771,32557,3830,840,408,432
2017,경기,용인시,중학교,50,31543,16280,15263,2173,158,63,95
2017,경기,용인시,고등학교,31,31038,16248,14790,2244,64,32,32
2017,경기,용인시,  (일반고),28,28843,15238,13605,2090,56,27,29
2017,경기,용인시,  (특성화고),2,1096,592,504,95,7,4,3
2017,경기,용인시,  (자율고),1,1099,418,681,59,1,1,0
2017,경기,용인시,특수학교,1,152,98,54,53,0,0,0
2017,경기,용인시,각종학교,1,0,0,0,1,0,0,0
2017,경기,군포시,유치원,49,3979,2008,1971,281,0,0,0
2017,경기,군포시,초등학교,26,15850,8215,7635,978,397,203,194
2017,경기,군포시,중학교,12,8200,4217,3983,582,75,34,41
2017,경기,군포시,고등학교,8,8705,4792,3913,700,28,16,12
2017,경기,군포시,  (일반고),5,6761,3498,3263,486,13,5,8
2017,경기,군포시,  (특성화고),2,1248,937,311,155,13,9,4
2017,경기,군포시,  (자율고),1,696,357,339,59,2,2,0
2017,경기,의왕시,유치원,24,1821,908,913,140,0,0,0
2017,경기,의왕시,초등학교,13,7487,3920,3567,470,113,58,55
2017,경기,의왕시,중학교,7,3555,1805,1750,251,21,17,4
2017,경기,의왕시,고등학교,5,4064,1847,2217,328,7,2,5
2017,경기,의왕시,  (일반고),3,2741,1346,1395,214,4,1,3
2017,경기,의왕시,  (특목고),1,643,166,477,54,1,0,1
2017,경기,의왕시,  (자율고),1,680,335,345,60,2,1,1
2017,경기,시흥시,유치원,67,5461,2787,2674,388,0,0,0
2017,경기,시흥시,초등학교,40,25140,12774,12366,1524,1296,654,642
2017,경기,시흥시,중학교,23,12817,6709,6108,898,220,103,117
2017,경기,시흥시,고등학교,16,15184,8272,6912,1112,108,65,43
2017,경기,시흥시,  (일반고),11,11478,5764,5714,822,67,30,37
2017,경기,시흥시,  (특성화고),4,2835,2144,691,221,39,34,5
2017,경기,시흥시,  (자율고),1,871,364,507,69,2,1,1
2017,경기,평택시,유치원,108,7866,3987,3879,594,0,0,0
2017,경기,평택시,초등학교,54,28674,14697,13977,1788,932,478,454
2017,경기,평택시,중학교,24,14133,7318,6815,970,199,80,119
2017,경기,평택시,고등학교,21,17331,9263,8068,1281,95,38,57
2017,경기,평택시,  (일반고),16,14306,7320,6986,1012,67,27,40
2017,경기,평택시,  (특목고),1,495,439,56,66,1,1,0
2017,경기,평택시,  (특성화고),4,2530,1504,1026,203,27,10,17
2017,경기,평택시,특수학교,2,248,178,70,96,0,0,0
2017,경기,화성시,유치원,148,16066,8159,7907,1039,0,0,0
2017,경기,화성시,초등학교,83,52593,26796,25797,3071,1137,567,570
2017,경기,화성시,중학교,36,21777,11155,10622,1481,191,94,97
2017,경기,화성시,고등학교,24,19125,9550,9575,1317,63,27,36
2017,경기,화성시,  (일반고),20,17716,9139,8577,1154,60,26,34
2017,경기,화성시,  (특목고),1,601,125,476,75,1,0,1
2017,경기,화성시,  (특성화고),3,808,286,522,88,2,1,1
2017,경기,화성시,특수학교,3,254,179,75,99,0,0,0
2017,경기,오산시,유치원,50,6500,3272,3228,411,0,0,0
2017,경기,오산시,초등학교,22,15696,8125,7571,915,498,270,228
2017,경기,오산시,중학교,9,6816,3507,3309,439,62,32,30
2017,경기,오산시,고등학교,8,7533,3844,3689,559,32,14,18
2017,경기,오산시,  (일반고),6,5832,3025,2807,413,22,11,11
2017,경기,오산시,  (특성화고),1,806,477,329,73,10,3,7
2017,경기,오산시,  (자율고),1,895,342,553,73,0,0,0
2017,경기,오산시,특수학교,1,122,93,29,51,0,0,0
2017,경기,광명시,유치원,51,4274,2148,2126,305,0,0,0
2017,경기,광명시,초등학교,24,19436,9928,9508,1152,452,206,246
2017,경기,광명시,중학교,11,9786,5124,4662,711,85,41,44
2017,경기,광명시,고등학교,11,10394,5526,4868,907,22,6,16
2017,경기,광명시,  (일반고),8,8782,4600,4182,738,13,3,10
2017,경기,광명시,  (특성화고),2,914,582,332,104,9,3,6
2017,경기,광명시,  (자율고),1,698,344,354,65,0,0,0
2017,경기,광주시,유치원,39,2734,1359,1375,195,0,0,0
2017,경기,광주시,초등학교,26,17608,8903,8705,946,569,311,258
2017,경기,광주시,중학교,11,7589,3902,3687,493,75,30,45
2017,경기,광주시,고등학교,7,7372,3501,3871,537,36,16,20
2017,경기,광주시,  (일반고),6,6918,3501,3417,500,33,16,17
2017,경기,광주시,  (특성화고),1,454,0,454,37,3,0,3
2017,경기,광주시,특수학교,4,304,200,104,131,0,0,0
2017,경기,하남시,유치원,32,2620,1343,1277,165,0,0,0
2017,경기,하남시,초등학교,20,12281,6326,5955,702,201,100,101
2017,경기,하남시,중학교,11,4862,2474,2388,364,36,12,24
2017,경기,하남시,고등학교,9,5062,2559,2503,503,33,13,20
2017,경기,하남시,  (일반고),7,3889,1946,1943,381,19,5,14
2017,경기,하남시,  (특성화고),2,1173,613,560,122,14,8,6
2017,경기,하남시,특수학교,1,130,90,40,50,0,0,0
2017,경기,하남시,고등공민학교,1,28,16,12,6,0,0,0
2017,경기,김포시,유치원,91,9551,4811,4740,660,0,0,0
2017,경기,김포시,초등학교,42,25578,13196,12382,1492,564,308,256
2017,경기,김포시,중학교,22,11101,5663,5438,760,121,67,54
2017,경기,김포시,고등학교,13,10741,5600,5141,844,60,31,29
2017,경기,김포시,  (일반고),11,9379,4762,4617,732,55,26,29
2017,경기,김포시,  (특목고),1,593,219,374,43,1,1,0
2017,경기,김포시,  (특성화고),1,769,619,150,69,4,4,0
2017,경기,김포시,특수학교,1,160,104,56,63,0,0,0
2017,경기,이천시,유치원,54,2897,1450,1447,224,0,0,0
2017,경기,이천시,초등학교,31,12988,6766,6222,879,354,178,176
2017,경기,이천시,중학교,15,6471,3372,3099,493,94,44,50
2017,경기,이천시,고등학교,12,7655,3917,3738,616,84,37,47
2017,경기,이천시,  (일반고),10,7277,3771,3506,574,80,34,46
2017,경기,이천시,  (특성화고),2,378,146,232,42,4,3,1
2017,경기,이천시,특수학교,1,126,101,25,52,0,0,0
2017,경기,이천시,각종학교,1,0,0,0,11,0,0,0
2017,경기,안성시,유치원,51,2685,1351,1334,209,0,0,0
2017,경기,안성시,초등학교,34,10734,5551,5183,798,482,236,246
2017,경기,안성시,중학교,13,5131,2675,2456,390,109,58,51
2017,경기,안성시,고등학교,9,5521,2886,2635,400,91,50,41
2017,경기,안성시,  (일반고),6,4473,2142,2331,308,33,15,18
2017,경기,안성시,  (특성화고),3,1048,744,304,92,58,35,23
2017,경기,안성시,특수학교,1,53,32,21,21,0,0,0
2017,경기,여주시,유치원,34,1324,717,607,109,0,0,0
2017,경기,여주시,초등학교,23,5548,2850,2698,448,218,99,119
2017,경기,여주시,중학교,13,2825,1437,1388,280,46,21,25
2017,경기,여주시,고등학교,9,3553,1775,1778,320,32,15,17
2017,경기,여주시,  (일반고),7,2740,1379,1361,215,23,10,13
2017,경기,여주시,  (특성화고),2,813,396,417,105,9,5,4
2017,경기,양평군,유치원,27,676,364,312,64,0,0,0
2017,경기,양평군,초등학교,22,5118,2631,2487,416,197,93,104
2017,경기,양평군,중학교,12,2638,1448,1190,248,36,19,17
2017,경기,양평군,고등학교,8,3472,1792,1680,294,18,7,11
2017,경기,양평군,  (일반고),7,3137,1516,1621,265,15,5,10
2017,경기,양평군,  (특성화고),1,335,276,59,29,3,2,1
2017,경기,양평군,특수학교,1,102,60,42,45,0,0,0
2017,경기,고양시,유치원,175,15028,7623,7405,1095,0,0,0
2017,경기,고양시,초등학교,83,54467,27983,26484,3138,874,441,433
2017,경기,고양시,중학교,41,30157,15570,14587,2054,168,81,87
2017,경기,고양시,고등학교,36,36775,19029,17746,2898,108,52,56
2017,경기,고양시,  (일반고),27,29127,15770,13357,2255,84,41,43
2017,경기,고양시,  (특목고),3,2218,546,1672,164,3,1,2
2017,경기,고양시,  (특성화고),5,4386,2150,2236,399,21,10,11
2017,경기,고양시,  (자율고),1,1044,563,481,80,0,0,0
2017,경기,고양시,특수학교,4,509,351,158,198,0,0,0
2017,경기,고양시,각종학교,2,387,204,183,37,6,0,6
2017,경기,남양주시,유치원,110,10905,5553,5352,759,0,0,0
2017,경기,남양주시,초등학교,60,41985,21634,20351,2339,744,351,393
2017,경기,남양주시,중학교,32,19906,10269,9637,1355,160,82,78
2017,경기,남양주시,고등학교,20,20923,10605,10318,1547,93,50,43
2017,경기,남양주시,  (일반고),17,18638,9305,9333,1364,78,36,42
2017,경기,남양주시,  (특성화고),1,732,659,73,60,13,13,0
2017,경기,남양주시,  (자율고),2,1553,641,912,123,2,1,1
2017,경기,남양주시,특수학교,1,206,128,78,72,0,0,0
2017,경기,구리시,유치원,34,2694,1368,1326,201,0,0,0
2017,경기,구리시,초등학교,16,9780,5166,4614,573,148,82,66
2017,경기,구리시,중학교,8,5074,2595,2479,343,64,32,32
2017,경기,구리시,고등학교,7,6383,3362,3021,505,38,19,19
2017,경기,구리시,  (일반고),7,6383,3362,3021,505,38,19,19
2017,경기,구리시,각종학교,1,746,393,353,43,0,0,0
2017,경기,의정부시,유치원,66,5332,2693,2639,420,0,0,0
2017,경기,의정부시,초등학교,33,21918,11297,10621,1306,388,230,158
2017,경기,의정부시,중학교,19,12343,6348,5995,887,86,36,50
2017,경기,의정부시,고등학교,16,15035,8294,6741,1254,60,26,34
2017,경기,의정부시,  (일반고),12,11830,6309,5521,947,32,14,18
2017,경기,의정부시,  (특목고),1,271,221,50,48,1,0,1
2017,경기,의정부시,  (특성화고),3,2934,1764,1170,259,27,12,15
2017,경기,의정부시,특수학교,2,251,168,83,84,0,0,0
2017,경기,파주시,유치원,99,7715,3876,3839,518,0,0,0
2017,경기,파주시,초등학교,57,27888,14219,13669,1689,668,334,334
2017,경기,파주시,중학교,25,12907,6752,6155,890,111,63,48
2017,경기,파주시,고등학교,18,13498,6737,6761,1056,64,37,27
2017,경기,파주시,  (일반고),15,11496,5562,5934,890,45,22,23
2017,경기,파주시,  (특성화고),2,974,741,233,86,19,15,4
2017,경기,파주시,  (자율고),1,1028,434,594,80,0,0,0
2017,경기,파주시,특수학교,2,320,208,112,121,0,0,0
2017,경기,동두천시,유치원,19,844,425,419,73,0,0,0
2017,경기,동두천시,초등학교,11,5231,2619,2612,340,234,110,124
2017,경기,동두천시,중학교,6,2652,1394,1258,197,58,38,20
2017,경기,동두천시,고등학교,6,3394,1602,1792,284,30,12,18
2017,경기,동두천시,  (일반고),4,2119,1062,1057,169,20,7,13
2017,경기,동두천시,  (특목고),1,628,193,435,59,7,2,5
2017,경기,동두천시,  (특성화고),1,647,347,300,56,3,3,0
2017,경기,양주시,유치원,48,2983,1483,1500,244,0,0,0
2017,경기,양주시,초등학교,32,13026,6720,6306,838,431,217,214
2017,경기,양주시,중학교,10,6173,3117,3056,401,77,41,36
2017,경기,양주시,고등학교,7,5914,2945,2969,427,32,13,19
2017,경기,양주시,  (일반고),5,4883,2505,2378,340,28,11,17
2017,경기,양주시,  (특성화고),1,353,125,228,30,3,1,2
2017,경기,양주시,  (자율고),1,678,315,363,57,1,1,0
2017,경기,양주시,각종학교,1,176,102,74,16,3,2,1
2017,경기,포천시,유치원,39,1260,644,616,111,0,0,0
2017,경기,포천시,초등학교,31,7217,3788,3429,568,401,198,203
2017,경기,포천시,중학교,14,3949,2080,1869,353,86,37,49
2017,경기,포천시,고등학교,7,4367,2335,2032,380,47,17,30
2017,경기,포천시,  (일반고),6,4217,2214,2003,355,47,17,30
2017,경기,포천시,  (특성화고),1,150,121,29,25,0,0,0
2017,경기,가평군,유치원,16,374,183,191,37,0,0,0
2017,경기,가평군,초등학교,13,2651,1390,1261,249,289,139,150
2017,경기,가평군,중학교,6,1628,841,787,132,135,72,63
2017,경기,가평군,고등학교,5,1826,970,856,174,127,65,62
2017,경기,가평군,  (일반고),4,1522,836,686,147,109,57,52
2017,경기,가평군,  (특목고),1,304,134,170,27,18,8,10
2017,경기,연천군,유치원,13,431,241,190,37,0,0,0
2017,경기,연천군,초등학교,13,1802,949,853,196,121,73,48
2017,경기,연천군,중학교,6,920,491,429,116,20,13,7
2017,경기,연천군,고등학교,2,1116,628,488,103,19,7,12
2017,경기,연천군,  (일반고),2,1116,628,488,103,19,7,12
2017,경기,연천군,각종학교,1,25,0,25,5,1,0,1
2018,경기,수원시,유치원,195,20185,10245,9940,1496,0,0,0
2018,경기,수원시,초등학교,97,69067,35569,33498,3953,1811,943,868
2018,경기,수원시,중학교,56,34082,17518,16564,2357,337,146,191
2018,경기,수원시,고등학교,44,41532,22117,19415,3609,172,83,89
2018,경기,수원시,  (일반고),31,32074,16999,15075,2658,82,28,54
2018,경기,수원시,  (특목고),4,1769,1018,751,241,13,10,3
2018,경기,수원시,  (특성화고),8,6861,3272,3589,633,72,40,32
2018,경기,수원시,  (자율고),1,828,828,0,77,5,5,0
2018,경기,수원시,특수학교,3,455,314,141,191,0,0,0
2018,경기,성남시,유치원,133,10848,5410,5438,913,0,0,0
2018,경기,성남시,초등학교,72,47386,24342,23044,2924,1017,500,517
2018,경기,성남시,중학교,45,24820,12956,11864,1892,237,118,119
2018,경기,성남시,고등학교,36,30215,15423,14792,2682,138,70,68
2018,경기,성남시,  (일반고),27,23375,12323,11052,2022,92,49,43
2018,경기,성남시,  (특목고),2,1598,300,1298,105,6,3,3
2018,경기,성남시,  (특성화고),7,5242,2800,2442,555,40,18,22
2018,경기,성남시,특수학교,2,405,270,135,169,0,0,0
2018,경기,성남시,각종학교,2,490,77,413,36,32,12,20
2018,경기,부천시,유치원,126,10934,5553,5381,846,0,0,0
2018,경기,부천시,초등학교,64,41572,21265,20307,2503,1546,839,707
2018,경기,부천시,중학교,32,20333,10419,9914,1507,294,163,131
2018,경기,부천시,고등학교,28,23385,12102,11283,2188,171,66,105
2018,경기,부천시,  (일반고),23,19047,9874,9173,1758,113,41,72
2018,경기,부천시,  (특목고),1,725,139,586,45,1,0,1
2018,경기,부천시,  (특성화고),4,3613,2089,1524,385,57,25,32
2018,경기,부천시,특수학교,2,356,245,111,130,0,0,0
2018,경기,안양시,유치원,82,6474,3244,3230,528,0,0,0
2018,경기,안양시,초등학교,41,29276,15109,14167,1667,555,287,268
2018,경기,안양시,중학교,24,15642,8135,7507,1087,93,48,45
2018,경기,안양시,고등학교,21,20422,10502,9920,1711,96,41,55
2018,경기,안양시,  (일반고),13,14284,7606,6678,1097,38,17,21
2018,경기,안양시,  (특목고),2,1563,414,1149,108,8,1,7
2018,경기,안양시,  (특성화고),6,4575,2482,2093,506,50,23,27
2018,경기,안양시,특수학교,1,223,152,71,97,0,0,0
2018,경기,과천시,유치원,7,353,194,159,33,0,0,0
2018,경기,과천시,초등학교,4,2799,1467,1332,173,15,11,4
2018,경기,과천시,중학교,2,1784,954,830,125,3,1,2
2018,경기,과천시,고등학교,4,2696,1223,1473,250,8,1,7
2018,경기,과천시,  (일반고),3,1979,1033,946,193,5,1,4
2018,경기,과천시,  (특목고),1,717,190,527,57,3,0,3
2018,경기,안산시,유치원,98,8336,4177,4159,658,0,0,0
2018,경기,안산시,초등학교,54,35622,18306,17316,2120,2972,1536,1436
2018,경기,안산시,중학교,29,19173,9852,9321,1370,650,314,336
2018,경기,안산시,고등학교,24,24848,12803,12045,2079,425,197,228
2018,경기,안산시,  (일반고),17,18183,9469,8714,1526,200,85,115
2018,경기,안산시,  (특성화고),6,5470,2872,2598,473,224,112,112
2018,경기,안산시,  (자율고),1,1195,462,733,80,1,0,1
2018,경기,안산시,특수학교,2,284,188,96,102,0,0,0
2018,경기,용인시,유치원,173,17554,8871,8683,1201,0,0,0
2018,경기,용인시,초등학교,102,68419,35146,33273,3967,852,453,399
2018,경기,용인시,중학교,50,31352,16184,15168,2160,175,79,96
2018,경기,용인시,고등학교,31,29363,15412,13951,2264,64,28,36
2018,경기,용인시,  (일반고),28,27313,14481,12832,2108,53,23,30
2018,경기,용인시,  (특성화고),2,951,507,444,95,8,4,4
2018,경기,용인시,  (자율고),1,1099,424,675,61,3,1,2
2018,경기,용인시,특수학교,1,149,100,49,55,0,0,0
2018,경기,용인시,각종학교,2,118,53,65,13,1,1,0
2018,경기,군포시,유치원,49,3650,1860,1790,273,0,0,0
2018,경기,군포시,초등학교,26,15530,8057,7473,982,471,248,223
2018,경기,군포시,중학교,12,7771,3958,3813,577,86,43,43
2018,경기,군포시,고등학교,8,7910,4298,3612,705,27,15,12
2018,경기,군포시,  (일반고),5,6291,3258,3033,503,14,7,7
2018,경기,군포시,  (특성화고),2,963,704,259,143,11,8,3
2018,경기,군포시,  (자율고),1,656,336,320,59,2,0,2
2018,경기,의왕시,유치원,24,1614,801,813,127,0,0,0
2018,경기,의왕시,초등학교,13,7397,3862,3535,475,134,78,56
2018,경기,의왕시,중학교,7,3328,1698,1630,244,22,16,6
2018,경기,의왕시,고등학교,5,3829,1747,2082,316,5,2,3
2018,경기,의왕시,  (일반고),3,2563,1256,1307,215,4,2,2
2018,경기,의왕시,  (특목고),1,626,172,454,43,0,0,0
2018,경기,의왕시,  (자율고),1,640,319,321,58,1,0,1
2018,경기,시흥시,유치원,72,5821,2894,2927,410,0,0,0
2018,경기,시흥시,초등학교,44,27185,13894,13291,1653,1475,762,713
2018,경기,시흥시,중학교,23,12949,6648,6301,936,269,125,144
2018,경기,시흥시,고등학교,16,14286,7883,6403,1135,125,65,60
2018,경기,시흥시,  (일반고),11,10873,5548,5325,851,81,32,49
2018,경기,시흥시,  (특성화고),4,2568,1969,599,215,42,33,9
2018,경기,시흥시,  (자율고),1,845,366,479,69,2,0,2
2018,경기,평택시,유치원,110,7768,3886,3882,583,0,0,0
2018,경기,평택시,초등학교,56,29706,15233,14473,1814,1101,550,551
2018,경기,평택시,중학교,24,13814,7077,6737,960,235,88,147
2018,경기,평택시,고등학교,21,16330,8712,7618,1290,99,46,53
2018,경기,평택시,  (일반고),16,13422,6866,6556,1023,70,30,40
2018,경기,평택시,  (특목고),1,484,428,56,66,12,12,0
2018,경기,평택시,  (특성화고),4,2424,1418,1006,201,17,4,13
2018,경기,평택시,특수학교,2,244,170,74,93,0,0,0
2018,경기,화성시,유치원,165,17380,8772,8608,1235,0,0,0
2018,경기,화성시,초등학교,89,58143,29652,28491,3358,1383,687,696
2018,경기,화성시,중학교,39,23054,11768,11286,1555,206,98,108
2018,경기,화성시,고등학교,25,18995,9481,9514,1411,62,28,34
2018,경기,화성시,  (일반고),21,17616,9082,8534,1253,55,27,28
2018,경기,화성시,  (특목고),1,602,129,473,71,1,0,1
2018,경기,화성시,  (특성화고),3,777,270,507,87,6,1,5
2018,경기,화성시,특수학교,3,275,192,83,105,0,0,0
2018,경기,오산시,유치원,50,6222,3147,3075,430,0,0,0
2018,경기,오산시,초등학교,23,16320,8384,7936,965,596,305,291
2018,경기,오산시,중학교,9,6850,3538,3312,443,75,43,32
2018,경기,오산시,고등학교,8,7061,3583,3478,555,38,19,19
2018,경기,오산시,  (일반고),6,5407,2766,2641,410,29,16,13
2018,경기,오산시,  (특성화고),1,775,467,308,72,9,3,6
2018,경기,오산시,  (자율고),1,879,350,529,73,0,0,0
2018,경기,오산시,특수학교,1,130,96,34,51,0,0,0
2018,경기,광명시,유치원,50,3795,1946,1849,293,0,0,0
2018,경기,광명시,초등학교,25,19063,9708,9355,1178,520,245,275
2018,경기,광명시,중학교,11,9493,4958,4535,696,101,49,52
2018,경기,광명시,고등학교,11,9613,5175,4438,868,24,12,12
2018,경기,광명시,  (일반고),8,8025,4251,3774,699,13,5,8
2018,경기,광명시,  (특성화고),2,841,561,280,102,8,5,3
2018,경기,광명시,  (자율고),1,747,363,384,67,3,2,1
2018,경기,광주시,유치원,41,2959,1498,1461,232,0,0,0
2018,경기,광주시,초등학교,27,18814,9546,9268,1037,675,369,306
2018,경기,광주시,중학교,11,7841,4009,3832,531,98,50,48
2018,경기,광주시,고등학교,8,6825,3258,3567,551,37,17,20
2018,경기,광주시,  (일반고),7,6392,3258,3134,517,33,17,16
2018,경기,광주시,  (특성화고),1,433,0,433,34,4,0,4
2018,경기,광주시,특수학교,4,314,214,100,139,0,0,0
2018,경기,하남시,유치원,33,2917,1560,1357,201,0,0,0
2018,경기,하남시,초등학교,20,14275,7199,7076,828,209,96,113
2018,경기,하남시,중학교,11,5294,2719,2575,384,46,18,28
2018,경기,하남시,고등학교,9,5005,2568,2437,516,22,10,12
2018,경기,하남시,  (일반고),7,3872,1983,1889,394,16,5,11
2018,경기,하남시,  (특성화고),2,1133,585,548,122,6,5,1
2018,경기,하남시,특수학교,1,126,91,35,49,0,0,0
2018,경기,하남시,고등공민학교,1,35,22,13,5,0,0,0
2018,경기,김포시,유치원,93,10257,5212,5045,657,0,0,0
2018,경기,김포시,초등학교,42,28484,14622,13862,1614,678,364,314
2018,경기,김포시,중학교,22,11362,5742,5620,785,115,63,52
2018,경기,김포시,고등학교,13,10442,5447,4995,847,74,33,41
2018,경기,김포시,  (일반고),11,9141,4627,4514,736,67,28,39
2018,경기,김포시,  (특목고),1,568,215,353,46,3,1,2
2018,경기,김포시,  (특성화고),1,733,605,128,65,4,4,0
2018,경기,김포시,특수학교,1,174,112,62,68,0,0,0
2018,경기,이천시,유치원,53,2754,1419,1335,217,0,0,0
2018,경기,이천시,초등학교,31,13080,6781,6299,864,399,196,203
2018,경기,이천시,중학교,15,6277,3268,3009,477,92,40,52
2018,경기,이천시,고등학교,12,7078,3621,3457,613,73,31,42
2018,경기,이천시,  (일반고),10,6711,3483,3228,570,69,29,40
2018,경기,이천시,  (특성화고),2,367,138,229,43,4,2,2
2018,경기,이천시,특수학교,1,133,101,32,57,0,0,0
2018,경기,이천시,각종학교,1,0,0,0,11,0,0,0
2018,경기,안성시,유치원,51,2481,1250,1231,212,0,0,0
2018,경기,안성시,초등학교,35,10821,5597,5224,818,565,279,286
2018,경기,안성시,중학교,13,4903,2529,2374,390,115,58,57
2018,경기,안성시,고등학교,9,5199,2719,2480,416,99,54,45
2018,경기,안성시,  (일반고),6,4194,2009,2185,320,35,15,20
2018,경기,안성시,  (특성화고),3,1005,710,295,96,64,39,25
2018,경기,안성시,특수학교,1,48,29,19,23,0,0,0
2018,경기,여주시,유치원,34,1191,634,557,107,0,0,0
2018,경기,여주시,초등학교,23,5526,2841,2685,453,227,103,124
2018,경기,여주시,중학교,13,2733,1432,1301,273,59,33,26
2018,경기,여주시,고등학교,9,3358,1686,1672,318,51,23,28
2018,경기,여주시,  (일반고),7,2578,1286,1292,215,35,15,20
2018,경기,여주시,  (특성화고),2,780,400,380,103,16,8,8
2018,경기,양평군,유치원,25,618,315,303,62,0,0,0
2018,경기,양평군,초등학교,22,5272,2688,2584,426,215,100,115
2018,경기,양평군,중학교,12,2643,1450,1193,258,40,22,18
2018,경기,양평군,고등학교,8,3174,1672,1502,299,19,10,9
2018,경기,양평군,  (일반고),7,2890,1432,1458,269,15,7,8
2018,경기,양평군,  (특성화고),1,284,240,44,30,4,3,1
2018,경기,양평군,특수학교,1,104,56,48,45,0,0,0
2018,경기,고양시,유치원,175,14242,7258,6984,1101,0,0,0
2018,경기,고양시,초등학교,83,54797,28071,26726,3160,1020,525,495
2018,경기,고양시,중학교,41,29047,14924,14123,2046,187,100,87
2018,경기,고양시,고등학교,36,33592,17415,16177,2876,120,53,67
2018,경기,고양시,  (일반고),27,26432,14305,12127,2226,79,37,42
2018,경기,고양시,  (특목고),3,2161,533,1628,169,10,2,8
2018,경기,고양시,  (특성화고),5,3994,2027,1967,401,31,14,17
2018,경기,고양시,  (자율고),1,1005,550,455,80,0,0,0
2018,경기,고양시,특수학교,4,512,361,151,201,0,0,0
2018,경기,고양시,각종학교,2,383,204,179,38,3,1,2
2018,경기,남양주시,유치원,110,10540,5337,5203,763,0,0,0
2018,경기,남양주시,초등학교,61,43187,22224,20963,2393,775,372,403
2018,경기,남양주시,중학교,32,19646,10086,9560,1367,173,80,93
2018,경기,남양주시,고등학교,20,19654,10074,9580,1554,95,61,34
2018,경기,남양주시,  (일반고),17,17596,8845,8751,1362,79,47,32
2018,경기,남양주시,  (특성화고),1,646,581,65,61,14,13,1
2018,경기,남양주시,  (자율고),2,1412,648,764,131,2,1,1
2018,경기,남양주시,특수학교,1,198,127,71,73,0,0,0
2018,경기,구리시,유치원,32,2493,1279,1214,192,0,0,0
2018,경기,구리시,초등학교,16,10151,5306,4845,605,166,91,75
2018,경기,구리시,중학교,8,4953,2567,2386,348,62,34,28
2018,경기,구리시,고등학교,7,5749,3036,2713,490,35,16,19
2018,경기,구리시,  (일반고),7,5749,3036,2713,490,35,16,19
2018,경기,구리시,각종학교,1,716,355,361,41,0,0,0
2018,경기,의정부시,유치원,64,5120,2613,2507,410,0,0,0
2018,경기,의정부시,초등학교,33,22370,11523,10847,1304,478,277,201
2018,경기,의정부시,중학교,19,11702,6010,5692,838,80,43,37
2018,경기,의정부시,고등학교,16,13979,7634,6345,1252,68,28,40
2018,경기,의정부시,  (일반고),12,10986,5773,5213,949,39,16,23
2018,경기,의정부시,  (특목고),1,276,225,51,49,2,1,1
2018,경기,의정부시,  (특성화고),3,2717,1636,1081,254,27,11,16
2018,경기,의정부시,특수학교,2,256,170,86,88,0,0,0
2018,경기,파주시,유치원,99,7593,3705,3888,550,0,0,0
2018,경기,파주시,초등학교,57,28569,14559,14010,1748,765,378,387
2018,경기,파주시,중학교,25,12823,6654,6169,878,133,75,58
2018,경기,파주시,고등학교,18,12920,6482,6438,1087,58,30,28
2018,경기,파주시,  (일반고),15,10951,5334,5617,925,47,20,27
2018,경기,파주시,  (특성화고),2,959,724,235,83,10,9,1
2018,경기,파주시,  (자율고),1,1010,424,586,79,1,1,0
2018,경기,파주시,특수학교,2,324,210,114,122,0,0,0
2018,경기,동두천시,유치원,19,733,359,374,67,0,0,0
2018,경기,동두천시,초등학교,11,5179,2589,2590,340,256,120,136
2018,경기,동두천시,중학교,6,2547,1317,1230,192,75,41,34
2018,경기,동두천시,고등학교,6,3126,1486,1640,283,37,16,21
2018,경기,동두천시,  (일반고),4,1885,947,938,166,26,10,16
2018,경기,동두천시,  (특목고),1,623,192,431,64,4,1,3
2018,경기,동두천시,  (특성화고),1,618,347,271,53,7,5,2
2018,경기,양주시,유치원,49,2880,1452,1428,248,0,0,0
2018,경기,양주시,초등학교,33,13088,6668,6420,862,462,236,226
2018,경기,양주시,중학교,10,6148,3144,3004,414,80,42,38
2018,경기,양주시,고등학교,7,5614,2780,2834,435,38,17,21
2018,경기,양주시,  (일반고),5,4673,2346,2327,349,33,14,19
2018,경기,양주시,  (특성화고),1,345,132,213,31,4,3,1
2018,경기,양주시,  (자율고),1,596,302,294,55,1,0,1
2018,경기,양주시,각종학교,1,220,124,96,19,1,0,1
2018,경기,포천시,유치원,35,1164,559,605,111,0,0,0
2018,경기,포천시,초등학교,31,7046,3699,3347,571,456,217,239
2018,경기,포천시,중학교,14,3618,1914,1704,344,99,44,55
2018,경기,포천시,고등학교,7,4035,2165,1870,373,48,26,22
2018,경기,포천시,  (일반고),6,3882,2037,1845,350,48,26,22
2018,경기,포천시,  (특성화고),1,153,128,25,23,0,0,0
2018,경기,가평군,유치원,15,322,166,156,35,0,0,0
2018,경기,가평군,초등학교,13,2587,1345,1242,248,273,129,144
2018,경기,가평군,중학교,6,1591,796,795,135,124,68,56
2018,경기,가평군,고등학교,5,1718,901,817,171,129,66,63
2018,경기,가평군,  (일반고),4,1413,787,626,147,119,62,57
2018,경기,가평군,  (특목고),1,305,114,191,24,10,4,6
2018,경기,연천군,유치원,13,447,223,224,39,0,0,0
2018,경기,연천군,초등학교,13,1768,928,840,198,116,71,45
2018,경기,연천군,중학교,6,865,460,405,111,34,21,13
2018,경기,연천군,고등학교,2,1055,600,455,102,26,16,10
2018,경기,연천군,  (일반고),2,1055,600,455,102,26,16,10
2018,경기,연천군,각종학교,1,25,0,25,4,1,0,1
2019,경기,수원시,유치원,192,18404,9408,8996,1444,0,0,0
2019,경기,수원시,초등학교,99,69546,35869,33677,4065,2088,1071,1017
2019,경기,수원시,중학교,56,32726,16756,15970,2373,430,186,244
2019,경기,수원시,고등학교,44,38211,20388,17823,3539,190,89,101
2019,경기,수원시,  (일반고),31,28898,15225,13673,2572,105,33,72
2019,경기,수원시,  (특목고),4,1760,999,761,244,9,8,1
2019,경기,수원시,  (특성화고),8,6764,3375,3389,652,68,40,28
2019,경기,수원시,  (자율고),1,789,789,0,71,8,8,0
2019,경기,수원시,특수학교,3,449,304,145,186,0,0,0
2019,경기,성남시,유치원,127,9843,4872,4971,868,0,0,0
2019,경기,성남시,초등학교,72,46942,24230,22712,2876,1131,561,570
2019,경기,성남시,중학교,45,23558,12217,11341,1852,256,131,125
2019,경기,성남시,고등학교,36,27606,14107,13499,2584,150,72,78
2019,경기,성남시,  (일반고),27,21179,11247,9932,1938,96,49,47
2019,경기,성남시,  (특목고),2,1594,303,1291,108,7,4,3
2019,경기,성남시,  (특성화고),7,4833,2557,2276,538,47,19,28
2019,경기,성남시,특수학교,2,400,275,125,163,0,0,0
2019,경기,성남시,각종학교,2,487,77,410,36,35,12,23
2019,경기,부천시,유치원,124,10081,5122,4959,823,0,0,0
2019,경기,부천시,초등학교,64,41053,20964,20089,2486,1887,1010,877
2019,경기,부천시,중학교,32,19403,9929,9474,1494,373,206,167
2019,경기,부천시,고등학교,28,21090,10746,10344,2103,185,82,103
2019,경기,부천시,  (일반고),23,17039,8737,8302,1685,125,51,74
2019,경기,부천시,  (특목고),1,723,143,580,43,0,0,0
2019,경기,부천시,  (특성화고),4,3328,1866,1462,375,60,31,29
2019,경기,부천시,특수학교,2,354,243,111,126,0,0,0
2019,경기,안양시,유치원,79,5974,3005,2969,510,0,0,0
2019,경기,안양시,초등학교,41,28467,14669,13798,1638,613,322,291
2019,경기,안양시,중학교,24,14858,7705,7153,1125,101,52,49
2019,경기,안양시,고등학교,21,18623,9547,9076,1667,111,46,65
2019,경기,안양시,  (일반고),13,13044,7039,6005,1074,44,20,24
2019,경기,안양시,  (특목고),2,1555,395,1160,108,6,0,6
2019,경기,안양시,  (특성화고),6,4024,2113,1911,485,61,26,35
2019,경기,안양시,특수학교,1,224,153,71,90,0,0,0
2019,경기,과천시,유치원,7,316,169,147,32,0,0,0
2019,경기,과천시,초등학교,4,2826,1458,1368,175,19,12,7
2019,경기,과천시,중학교,2,1690,922,768,124,2,1,1
2019,경기,과천시,고등학교,4,2359,1087,1272,239,5,0,5
2019,경기,과천시,  (일반고),3,1679,916,763,182,3,0,3
2019,경기,과천시,  (특목고),1,680,171,509,57,2,0,2
2019,경기,안산시,유치원,94,7360,3749,3611,578,0,0,0
2019,경기,안산시,초등학교,54,34954,17936,17018,2079,3338,1697,1641
2019,경기,안산시,중학교,29,18083,9252,8831,1329,814,411,403
2019,경기,안산시,고등학교,24,21871,11207,10664,2018,453,201,252
2019,경기,안산시,  (일반고),17,15634,8040,7594,1464,220,83,137
2019,경기,안산시,  (특성화고),6,5127,2710,2417,473,231,117,114
2019,경기,안산시,  (자율고),1,1110,457,653,81,2,1,1
2019,경기,안산시,특수학교,2,286,187,99,103,0,0,0
2019,경기,용인시,유치원,169,15584,7894,7690,1133,0,0,0
2019,경기,용인시,초등학교,103,70018,35792,34226,4161,967,509,458
2019,경기,용인시,중학교,50,31427,16296,15131,2259,225,98,127
2019,경기,용인시,고등학교,31,27591,14444,13147,2247,62,35,27
2019,경기,용인시,  (일반고),28,25629,13547,12082,2082,54,31,23
2019,경기,용인시,  (특성화고),2,880,491,389,99,6,3,3
2019,경기,용인시,  (자율고),1,1082,406,676,66,2,1,1
2019,경기,용인시,특수학교,1,146,101,45,54,0,0,0
2019,경기,용인시,각종학교,2,239,106,133,21,0,0,0
2019,경기,군포시,유치원,49,3245,1630,1615,263,0,0,0
2019,경기,군포시,초등학교,26,15126,7833,7293,956,538,291,247
2019,경기,군포시,중학교,12,7299,3728,3571,555,97,47,50
2019,경기,군포시,고등학교,8,7123,3819,3304,693,34,15,19
2019,경기,군포시,  (일반고),5,5681,2933,2748,499,17,8,9
2019,경기,군포시,  (특성화고),2,812,563,249,135,12,7,5
2019,경기,군포시,  (자율고),1,630,323,307,59,5,0,5
2019,경기,의왕시,유치원,24,1485,728,757,128,0,0,0
2019,경기,의왕시,초등학교,14,7490,3894,3596,499,146,79,67
2019,경기,의왕시,중학교,7,3295,1678,1617,257,24,13,11
2019,경기,의왕시,고등학교,5,3459,1655,1804,326,7,2,5
2019,경기,의왕시,  (일반고),3,2266,1166,1100,218,1,0,1
2019,경기,의왕시,  (특목고),1,608,183,425,50,4,1,3
2019,경기,의왕시,  (자율고),1,585,306,279,58,2,1,1
2019,경기,시흥시,유치원,74,6022,3026,2996,443,0,0,0
2019,경기,시흥시,초등학교,46,29619,15170,14449,1768,1951,986,965
2019,경기,시흥시,중학교,23,13195,6705,6490,967,388,197,191
2019,경기,시흥시,고등학교,16,13438,7372,6066,1143,127,70,57
2019,경기,시흥시,  (일반고),11,10286,5238,5048,854,89,39,50
2019,경기,시흥시,  (특성화고),4,2288,1750,538,216,36,31,5
2019,경기,시흥시,  (자율고),1,864,384,480,73,2,0,2
2019,경기,평택시,유치원,108,7281,3633,3648,563,0,0,0
2019,경기,평택시,초등학교,58,30978,15903,15075,1931,1253,645,608
2019,경기,평택시,중학교,25,13875,7139,6736,1015,264,110,154
2019,경기,평택시,고등학교,21,15183,8045,7138,1287,117,49,68
2019,경기,평택시,  (일반고),16,12393,6271,6122,1014,89,36,53
2019,경기,평택시,  (특목고),1,482,417,65,66,11,8,3
2019,경기,평택시,  (특성화고),4,2308,1357,951,207,17,5,12
2019,경기,평택시,특수학교,2,258,178,80,93,0,0,0
2019,경기,화성시,유치원,167,17442,8813,8629,1221,0,0,0
2019,경기,화성시,초등학교,92,63581,32457,31124,3679,1625,819,806
2019,경기,화성시,중학교,40,24824,12596,12228,1683,293,131,162
2019,경기,화성시,고등학교,26,19145,9523,9622,1508,76,31,45
2019,경기,화성시,  (일반고),22,17820,9148,8672,1347,66,29,37
2019,경기,화성시,  (특목고),1,590,127,463,73,3,0,3
2019,경기,화성시,  (특성화고),3,735,248,487,88,7,2,5
2019,경기,화성시,특수학교,3,292,194,98,110,0,0,0
2019,경기,오산시,유치원,50,5623,2747,2876,415,0,0,0
2019,경기,오산시,초등학교,23,16571,8551,8020,969,681,353,328
2019,경기,오산시,중학교,9,6853,3448,3405,459,103,58,45
2019,경기,오산시,고등학교,8,6685,3409,3276,552,35,17,18
2019,경기,오산시,  (일반고),6,5092,2605,2487,411,25,10,15
2019,경기,오산시,  (특성화고),1,725,444,281,68,10,7,3
2019,경기,오산시,  (자율고),1,868,360,508,73,0,0,0
2019,경기,오산시,특수학교,1,125,89,36,48,0,0,0
2019,경기,광명시,유치원,48,3435,1766,1669,302,0,0,0
2019,경기,광명시,초등학교,25,18420,9385,9035,1163,540,273,267
2019,경기,광명시,중학교,11,9108,4670,4438,690,106,52,54
2019,경기,광명시,고등학교,11,8809,4818,3991,846,29,15,14
2019,경기,광명시,  (일반고),8,7430,4014,3416,679,19,8,11
2019,경기,광명시,  (특성화고),2,710,496,214,99,5,5,0
2019,경기,광명시,  (자율고),1,669,308,361,68,5,2,3
2019,경기,광주시,유치원,42,2550,1299,1251,212,0,0,0
2019,경기,광주시,초등학교,27,19866,10089,9777,1067,760,409,351
2019,경기,광주시,중학교,11,8301,4252,4049,573,126,65,61
2019,경기,광주시,고등학교,8,6488,3055,3433,568,42,14,28
2019,경기,광주시,  (일반고),7,6079,3055,3024,532,34,14,20
2019,경기,광주시,  (특성화고),1,409,0,409,36,8,0,8
2019,경기,광주시,특수학교,4,316,223,93,137,0,0,0
2019,경기,하남시,유치원,34,3048,1546,1502,213,0,0,0
2019,경기,하남시,초등학교,20,16083,8197,7886,935,267,120,147
2019,경기,하남시,중학교,11,5731,2961,2770,440,46,22,24
2019,경기,하남시,고등학교,9,4884,2505,2379,511,27,12,15
2019,경기,하남시,  (일반고),7,3892,2002,1890,389,18,6,12
2019,경기,하남시,  (특성화고),2,992,503,489,122,9,6,3
2019,경기,하남시,특수학교,1,128,96,32,53,0,0,0
2019,경기,하남시,고등공민학교,1,43,27,16,5,0,0,0
2019,경기,김포시,유치원,90,10084,5078,5006,731,0,0,0
2019,경기,김포시,초등학교,43,31544,16049,15495,1749,778,431,347
2019,경기,김포시,중학교,22,11965,6089,5876,842,143,75,68
2019,경기,김포시,고등학교,13,10220,5306,4914,862,72,29,43
2019,경기,김포시,  (일반고),11,9013,4537,4476,746,65,24,41
2019,경기,김포시,  (특목고),1,524,198,326,49,3,1,2
2019,경기,김포시,  (특성화고),1,683,571,112,67,4,4,0
2019,경기,김포시,특수학교,1,187,125,62,73,0,0,0
2019,경기,이천시,유치원,51,2490,1296,1194,202,0,0,0
2019,경기,이천시,초등학교,31,13184,6780,6404,842,464,229,235
2019,경기,이천시,중학교,15,6123,3222,2901,495,115,52,63
2019,경기,이천시,고등학교,12,6503,3370,3133,619,63,21,42
2019,경기,이천시,  (일반고),10,6143,3238,2905,576,60,19,41
2019,경기,이천시,  (특성화고),2,360,132,228,43,3,2,1
2019,경기,이천시,특수학교,1,142,110,32,61,0,0,0
2019,경기,이천시,각종학교,1,0,0,0,11,0,0,0
2019,경기,안성시,유치원,51,2487,1290,1197,195,0,0,0
2019,경기,안성시,초등학교,35,10917,5588,5329,826,689,335,354
2019,경기,안성시,중학교,13,4815,2480,2335,392,137,66,71
2019,경기,안성시,고등학교,9,4874,2546,2328,414,50,33,17
2019,경기,안성시,  (일반고),6,3931,1875,2056,318,35,21,14
2019,경기,안성시,  (특성화고),3,943,671,272,96,15,12,3
2019,경기,안성시,특수학교,1,52,33,19,21,0,0,0
2019,경기,여주시,유치원,34,1066,552,514,101,0,0,0
2019,경기,여주시,초등학교,23,5428,2813,2615,463,242,115,127
2019,경기,여주시,중학교,13,2669,1396,1273,290,68,36,32
2019,경기,여주시,고등학교,9,3063,1526,1537,321,41,17,24
2019,경기,여주시,  (일반고),7,2323,1134,1189,217,27,9,18
2019,경기,여주시,  (특성화고),2,740,392,348,104,14,8,6
2019,경기,양평군,유치원,25,560,292,268,64,0,0,0
2019,경기,양평군,초등학교,22,5251,2704,2547,426,243,122,121
2019,경기,양평군,중학교,12,2659,1438,1221,279,41,22,19
2019,경기,양평군,고등학교,8,2973,1565,1408,300,19,8,11
2019,경기,양평군,  (일반고),7,2728,1352,1376,269,13,4,9
2019,경기,양평군,  (특성화고),1,245,213,32,31,6,4,2
2019,경기,양평군,특수학교,1,95,50,45,47,0,0,0
2019,경기,고양시,유치원,171,13049,6598,6451,1054,0,0,0
2019,경기,고양시,초등학교,84,54934,28165,26769,3238,1149,595,554
2019,경기,고양시,중학교,41,27578,13968,13610,2054,220,107,113
2019,경기,고양시,고등학교,36,30593,15858,14735,2827,97,50,47
2019,경기,고양시,  (일반고),27,23904,12995,10909,2192,64,33,31
2019,경기,고양시,  (특목고),3,2136,522,1614,176,7,4,3
2019,경기,고양시,  (특성화고),5,3596,1807,1789,373,25,12,13
2019,경기,고양시,  (자율고),1,957,534,423,86,1,1,0
2019,경기,고양시,특수학교,4,520,358,162,192,0,0,0
2019,경기,고양시,각종학교,2,399,212,187,43,3,0,3
2019,경기,남양주시,유치원,110,9895,4948,4947,763,0,0,0
2019,경기,남양주시,초등학교,64,44661,22934,21727,2547,876,425,451
2019,경기,남양주시,중학교,33,19824,10190,9634,1436,229,121,108
2019,경기,남양주시,고등학교,20,18452,9473,8979,1550,95,55,40
2019,경기,남양주시,  (일반고),17,16583,8323,8260,1363,80,43,37
2019,경기,남양주시,  (특성화고),1,535,487,48,62,11,10,1
2019,경기,남양주시,  (자율고),2,1334,663,671,125,4,2,2
2019,경기,남양주시,특수학교,1,205,134,71,76,0,0,0
2019,경기,구리시,유치원,30,2171,1142,1029,183,0,0,0
2019,경기,구리시,초등학교,16,10213,5297,4916,629,209,111,98
2019,경기,구리시,중학교,8,4755,2538,2217,354,48,30,18
2019,경기,구리시,고등학교,7,5163,2711,2452,476,47,22,25
2019,경기,구리시,  (일반고),7,5163,2711,2452,476,47,22,25
2019,경기,구리시,각종학교,1,703,349,354,46,0,0,0
2019,경기,의정부시,유치원,62,4929,2440,2489,408,0,0,0
2019,경기,의정부시,초등학교,33,22730,11706,11024,1344,549,306,243
2019,경기,의정부시,중학교,19,11297,5753,5544,828,92,45,47
2019,경기,의정부시,고등학교,16,12883,7001,5882,1231,82,39,43
2019,경기,의정부시,  (일반고),12,10140,5333,4807,923,42,21,21
2019,경기,의정부시,  (특목고),1,273,226,47,49,2,1,1
2019,경기,의정부시,  (특성화고),3,2470,1442,1028,259,38,17,21
2019,경기,의정부시,특수학교,2,227,150,77,85,0,0,0
2019,경기,파주시,유치원,98,7309,3628,3681,532,0,0,0
2019,경기,파주시,초등학교,57,29748,15187,14561,1829,821,396,425
2019,경기,파주시,중학교,25,12883,6602,6281,933,138,70,68
2019,경기,파주시,고등학교,18,12382,6275,6107,1081,72,38,34
2019,경기,파주시,  (일반고),15,10400,5157,5243,917,55,23,32
2019,경기,파주시,  (특성화고),2,934,687,247,84,16,14,2
2019,경기,파주시,  (자율고),1,1048,431,617,80,1,1,0
2019,경기,파주시,특수학교,2,329,218,111,125,0,0,0
2019,경기,동두천시,유치원,19,654,336,318,64,0,0,0
2019,경기,동두천시,초등학교,11,5014,2518,2496,323,281,143,138
2019,경기,동두천시,중학교,6,2399,1219,1180,198,82,35,47
2019,경기,동두천시,고등학교,6,2944,1413,1531,287,48,26,22
2019,경기,동두천시,  (일반고),4,1732,875,857,166,35,20,15
2019,경기,동두천시,  (특목고),1,610,191,419,66,4,1,3
2019,경기,동두천시,  (특성화고),1,602,347,255,55,9,5,4
2019,경기,양주시,유치원,48,2703,1357,1346,235,0,0,0
2019,경기,양주시,초등학교,33,13531,6845,6686,889,513,245,268
2019,경기,양주시,중학교,10,6144,3186,2958,440,90,46,44
2019,경기,양주시,고등학교,7,5356,2665,2691,430,42,18,24
2019,경기,양주시,  (일반고),5,4472,2199,2273,348,35,14,21
2019,경기,양주시,  (특성화고),1,342,155,187,29,6,4,2
2019,경기,양주시,  (자율고),1,542,311,231,53,1,0,1
2019,경기,양주시,특수학교,1,120,88,32,52,0,0,0
2019,경기,양주시,각종학교,1,210,121,89,16,4,2,2
2019,경기,포천시,유치원,33,986,512,474,103,0,0,0
2019,경기,포천시,초등학교,31,6727,3508,3219,568,494,232,262
2019,경기,포천시,중학교,14,3322,1766,1556,347,103,51,52
2019,경기,포천시,고등학교,7,3730,2006,1724,363,66,33,33
2019,경기,포천시,  (일반고),6,3579,1879,1700,339,66,33,33
2019,경기,포천시,  (특성화고),1,151,127,24,24,0,0,0
2019,경기,가평군,유치원,14,280,152,128,33,0,0,0
2019,경기,가평군,초등학교,13,2583,1302,1281,244,302,144,158
2019,경기,가평군,중학교,6,1541,758,783,142,122,68,54
2019,경기,가평군,고등학교,5,1570,858,712,171,117,61,56
2019,경기,가평군,  (일반고),4,1261,738,523,144,107,57,50
2019,경기,가평군,  (특목고),1,309,120,189,27,10,4,6
2019,경기,연천군,유치원,13,426,205,221,36,0,0,0
2019,경기,연천군,초등학교,13,1739,911,828,204,121,66,55
2019,경기,연천군,중학교,6,832,441,391,121,46,34,12
2019,경기,연천군,고등학교,2,897,520,377,106,22,13,9
2019,경기,연천군,  (일반고),2,897,520,377,106,22,13,9
2019,경기,연천군,각종학교,1,22,0,22,5,0,0,0
2020,경기,수원시,유치원,189,17358,8819,8539,1385,0,0,0
2020,경기,수원시,초등학교,99,67474,34816,32658,4053,2164,1117,1047
2020,경기,수원시,중학교,56,33013,16965,16048,2424,513,237,276
2020,경기,수원시,고등학교,44,36338,19412,16926,3545,239,109,130
2020,경기,수원시,  (일반고),31,27319,14330,12989,2577,136,42,94
2020,경기,수원시,  (특목고),4,1750,997,753,244,13,8,5
2020,경기,수원시,  (특성화고),8,6509,3325,3184,654,81,50,31
2020,경기,수원시,  (자율고),1,760,760,0,70,9,9,0
2020,경기,수원시,특수학교,3,457,317,140,191,0,0,0
2020,경기,성남시,유치원,123,9035,4490,4545,845,0,0,0
2020,경기,성남시,초등학교,72,45788,23628,22160,2854,1179,605,574
2020,경기,성남시,중학교,45,23453,12145,11308,1877,295,145,150
2020,경기,성남시,고등학교,36,26272,13379,12893,2569,178,85,93
2020,경기,성남시,  (일반고),27,20239,10710,9529,1924,106,52,54
2020,경기,성남시,  (특목고),2,1580,326,1254,107,6,0,6
2020,경기,성남시,  (특성화고),7,4453,2343,2110,538,66,33,33
2020,경기,성남시,특수학교,2,394,275,119,166,0,0,0
2020,경기,성남시,각종학교,2,484,83,401,40,30,10,20
2020,경기,부천시,유치원,125,9698,4859,4839,796,0,0,0
2020,경기,부천시,초등학교,64,38989,19935,19054,2437,2031,1034,997
2020,경기,부천시,중학교,32,19603,10045,9558,1541,470,251,219
2020,경기,부천시,고등학교,28,19733,9992,9741,2047,189,96,93
2020,경기,부천시,  (일반고),23,16085,8189,7896,1634,123,64,59
2020,경기,부천시,  (특목고),1,709,138,571,44,0,0,0
2020,경기,부천시,  (특성화고),4,2939,1665,1274,369,66,32,34
2020,경기,부천시,특수학교,2,349,237,112,123,0,0,0
2020,경기,안양시,유치원,77,5709,2905,2804,496,0,0,0
2020,경기,안양시,초등학교,41,27336,14073,13263,1610,647,333,314
2020,경기,안양시,중학교,24,14891,7740,7151,1155,121,52,69
2020,경기,안양시,고등학교,21,17267,8847,8420,1600,104,45,59
2020,경기,안양시,  (일반고),13,12280,6678,5602,1048,32,17,15
2020,경기,안양시,  (특목고),3,1765,510,1255,148,14,6,8
2020,경기,안양시,  (특성화고),5,3222,1659,1563,404,58,22,36
2020,경기,안양시,특수학교,1,219,144,75,89,0,0,0
2020,경기,과천시,유치원,7,357,185,172,33,0,0,0
2020,경기,과천시,초등학교,4,2882,1491,1391,176,17,11,6
2020,경기,과천시,중학교,2,1647,905,742,118,8,4,4
2020,경기,과천시,고등학교,4,2193,1036,1157,236,5,1,4
2020,경기,과천시,  (일반고),3,1530,872,658,176,2,0,2
2020,경기,과천시,  (특목고),1,663,164,499,60,3,1,2
2020,경기,안산시,유치원,90,6755,3416,3339,566,0,0,0
2020,경기,안산시,초등학교,55,33219,17011,16208,2035,3478,1782,1696
2020,경기,안산시,중학교,29,17799,9100,8699,1350,1023,486,537
2020,경기,안산시,고등학교,24,20264,10479,9785,1975,481,220,261
2020,경기,안산시,  (일반고),17,14388,7457,6931,1425,266,118,148
2020,경기,안산시,  (특성화고),6,4797,2528,2269,473,213,101,112
2020,경기,안산시,  (자율고),1,1079,494,585,77,2,1,1
2020,경기,안산시,특수학교,2,282,193,89,106,0,0,0
2020,경기,용인시,유치원,165,15301,7706,7595,1144,0,0,0
2020,경기,용인시,초등학교,103,68903,35216,33687,4074,1070,568,502
2020,경기,용인시,중학교,50,32763,16963,15800,2379,279,128,151
2020,경기,용인시,고등학교,31,27152,14145,13007,2235,72,36,36
2020,경기,용인시,  (일반고),28,25206,13260,11946,2072,62,31,31
2020,경기,용인시,  (특성화고),2,844,479,365,96,4,2,2
2020,경기,용인시,  (자율고),1,1102,406,696,67,6,3,3
2020,경기,용인시,특수학교,1,150,103,47,56,0,0,0
2020,경기,용인시,각종학교,2,357,173,184,31,0,0,0
2020,경기,군포시,유치원,49,2995,1531,1464,257,0,0,0
2020,경기,군포시,초등학교,27,14676,7596,7080,961,556,312,244
2020,경기,군포시,중학교,12,7302,3726,3576,564,114,50,64
2020,경기,군포시,고등학교,8,6730,3617,3113,686,40,17,23
2020,경기,군포시,  (일반고),5,5371,2815,2556,484,21,10,11
2020,경기,군포시,  (특성화고),2,765,493,272,143,16,7,9
2020,경기,군포시,  (자율고),1,594,309,285,59,3,0,3
2020,경기,의왕시,유치원,22,1331,670,661,117,0,0,0
2020,경기,의왕시,초등학교,14,7455,3807,3648,512,163,83,80
2020,경기,의왕시,중학교,7,3321,1709,1612,277,26,11,15
2020,경기,의왕시,고등학교,5,3321,1576,1745,322,7,4,3
2020,경기,의왕시,  (일반고),3,2164,1122,1042,215,1,1,0
2020,경기,의왕시,  (특목고),1,598,164,434,46,4,2,2
2020,경기,의왕시,  (자율고),1,559,290,269,61,2,1,1
2020,경기,시흥시,유치원,75,6013,2998,3015,473,0,0,0
2020,경기,시흥시,초등학교,46,30471,15687,14784,1815,2082,1052,1030
2020,경기,시흥시,중학교,24,13840,6938,6902,1057,448,218,230
2020,경기,시흥시,고등학교,17,13093,7108,5985,1173,148,77,71
2020,경기,시흥시,  (일반고),12,10046,5120,4926,866,103,43,60
2020,경기,시흥시,  (특성화고),4,2198,1608,590,233,44,34,10
2020,경기,시흥시,  (자율고),1,849,380,469,74,1,0,1
2020,경기,평택시,유치원,107,7118,3650,3468,589,0,0,0
2020,경기,평택시,초등학교,61,31602,16142,15460,1995,1438,733,705
2020,경기,평택시,중학교,25,14566,7489,7077,1082,322,169,153
2020,경기,평택시,고등학교,21,14748,7835,6913,1288,162,63,99
2020,경기,평택시,  (일반고),16,12075,6090,5985,1012,118,41,77
2020,경기,평택시,  (특목고),1,483,421,62,70,10,8,2
2020,경기,평택시,  (특성화고),4,2190,1324,866,206,34,14,20
2020,경기,평택시,특수학교,2,249,178,71,98,0,0,0
2020,경기,화성시,유치원,169,17822,8925,8897,1306,0,0,0
2020,경기,화성시,초등학교,95,66535,34042,32493,3855,1807,932,875
2020,경기,화성시,중학교,42,27377,13903,13474,1874,367,171,196
2020,경기,화성시,고등학교,28,19961,9831,10130,1630,107,45,62
2020,경기,화성시,  (일반고),24,18632,9421,9211,1465,97,43,54
2020,경기,화성시,  (특목고),1,594,145,449,77,2,0,2
2020,경기,화성시,  (특성화고),3,735,265,470,88,8,2,6
2020,경기,화성시,특수학교,3,310,207,103,122,0,0,0
2020,경기,오산시,유치원,48,5171,2623,2548,402,0,0,0
2020,경기,오산시,초등학교,25,16481,8509,7972,966,759,407,352
2020,경기,오산시,중학교,9,7129,3595,3534,475,127,70,57
2020,경기,오산시,고등학교,8,6573,3323,3250,561,42,19,23
2020,경기,오산시,  (일반고),7,5899,2931,2968,494,30,15,15
2020,경기,오산시,  (특성화고),1,674,392,282,67,12,4,8
2020,경기,오산시,특수학교,1,124,84,40,50,0,0,0
2020,경기,광명시,유치원,44,3040,1557,1483,269,0,0,0
2020,경기,광명시,초등학교,25,17318,8884,8434,1095,540,278,262
2020,경기,광명시,중학교,12,8912,4528,4384,698,126,66,60
2020,경기,광명시,고등학교,11,8371,4568,3803,826,34,13,21
2020,경기,광명시,  (일반고),8,6956,3729,3227,649,24,9,15
2020,경기,광명시,  (특성화고),2,716,501,215,108,7,4,3
2020,경기,광명시,  (자율고),1,699,338,361,69,3,0,3
2020,경기,광주시,유치원,42,2414,1246,1168,206,0,0,0
2020,경기,광주시,초등학교,29,19933,10190,9743,1141,815,431,384
2020,경기,광주시,중학교,11,8706,4380,4326,643,182,87,95
2020,경기,광주시,고등학교,8,6385,3021,3364,597,37,15,22
2020,경기,광주시,  (일반고),7,5994,3021,2973,561,33,15,18
2020,경기,광주시,  (특성화고),1,391,0,391,36,4,0,4
2020,경기,광주시,특수학교,4,323,234,89,146,0,0,0
2020,경기,하남시,유치원,35,3029,1537,1492,228,0,0,0
2020,경기,하남시,초등학교,21,16940,8609,8331,960,273,133,140
2020,경기,하남시,중학교,12,6461,3358,3103,505,69,35,34
2020,경기,하남시,고등학교,9,5034,2543,2491,525,25,13,12
2020,경기,하남시,  (일반고),7,4106,2096,2010,401,11,6,5
2020,경기,하남시,  (특성화고),2,928,447,481,124,14,7,7
2020,경기,하남시,특수학교,1,120,92,28,50,0,0,0
2020,경기,하남시,고등공민학교,1,31,20,11,5,0,0,0
2020,경기,김포시,유치원,92,9947,5083,4864,719,0,0,0
2020,경기,김포시,초등학교,44,32551,16543,16008,1856,871,476,395
2020,경기,김포시,중학교,22,12859,6515,6344,923,197,101,96
2020,경기,김포시,고등학교,14,10446,5408,5038,893,93,47,46
2020,경기,김포시,  (일반고),12,9305,4693,4612,774,80,37,43
2020,경기,김포시,  (특목고),1,505,201,304,49,3,0,3
2020,경기,김포시,  (특성화고),1,636,514,122,70,10,10,0
2020,경기,김포시,특수학교,1,197,131,66,72,0,0,0
2020,경기,이천시,유치원,48,2242,1117,1125,189,0,0,0
2020,경기,이천시,초등학교,31,12879,6595,6284,844,492,226,266
2020,경기,이천시,중학교,15,6304,3264,3040,518,123,57,66
2020,경기,이천시,고등학교,12,6124,3183,2941,615,80,29,51
2020,경기,이천시,  (일반고),10,5768,3051,2717,572,74,28,46
2020,경기,이천시,  (특성화고),2,356,132,224,43,6,1,5
2020,경기,이천시,특수학교,1,149,115,34,65,0,0,0
2020,경기,이천시,각종학교,1,0,0,0,11,0,0,0
2020,경기,안성시,유치원,51,2398,1219,1179,200,0,0,0
2020,경기,안성시,초등학교,35,10657,5488,5169,823,714,362,352
2020,경기,안성시,중학교,13,4986,2556,2430,403,160,71,89
2020,경기,안성시,고등학교,9,4589,2347,2242,415,48,24,24
2020,경기,안성시,  (일반고),6,3728,1768,1960,317,39,17,22
2020,경기,안성시,  (특성화고),3,861,579,282,98,9,7,2
2020,경기,안성시,특수학교,1,55,39,16,21,0,0,0
2020,경기,여주시,유치원,34,1039,527,512,100,0,0,0
2020,경기,여주시,초등학교,23,5248,2747,2501,444,254,131,123
2020,경기,여주시,중학교,13,2670,1375,1295,295,88,40,48
2020,경기,여주시,고등학교,9,2934,1474,1460,323,50,20,30
2020,경기,여주시,  (일반고),7,2218,1077,1141,214,29,12,17
2020,경기,여주시,  (특성화고),2,716,397,319,109,21,8,13
2020,경기,양평군,유치원,25,490,260,230,62,0,0,0
2020,경기,양평군,초등학교,22,5086,2635,2451,435,245,126,119
2020,경기,양평군,중학교,12,2708,1414,1294,293,47,22,25
2020,경기,양평군,고등학교,8,2859,1495,1364,300,24,13,11
2020,경기,양평군,  (일반고),7,2664,1315,1349,268,19,9,10
2020,경기,양평군,  (특성화고),1,195,180,15,32,5,4,1
2020,경기,양평군,특수학교,1,83,42,41,41,0,0,0
2020,경기,고양시,유치원,168,12679,6456,6223,1046,0,0,0
2020,경기,고양시,초등학교,87,54930,28079,26851,3276,1178,616,562
2020,경기,고양시,중학교,42,27615,14012,13603,2068,269,134,135
2020,경기,고양시,고등학교,36,29095,14927,14168,2795,141,66,75
2020,경기,고양시,  (일반고),27,22812,12303,10509,2162,89,42,47
2020,경기,고양시,  (특목고),3,2120,513,1607,178,14,5,9
2020,경기,고양시,  (특성화고),5,3224,1594,1630,374,35,16,19
2020,경기,고양시,  (자율고),1,939,517,422,81,3,3,0
2020,경기,고양시,특수학교,4,538,372,166,205,0,0,0
2020,경기,고양시,각종학교,2,435,224,211,43,3,1,2
2020,경기,남양주시,유치원,108,9449,4726,4723,768,0,0,0
2020,경기,남양주시,초등학교,65,44660,23005,21655,2591,896,459,437
2020,경기,남양주시,중학교,34,20805,10713,10092,1521,260,126,134
2020,경기,남양주시,고등학교,21,17975,9322,8653,1579,87,47,40
2020,경기,남양주시,  (일반고),19,16955,8660,8295,1456,77,40,37
2020,경기,남양주시,  (특성화고),1,449,391,58,62,10,7,3
2020,경기,남양주시,  (자율고),1,571,271,300,61,0,0,0
2020,경기,남양주시,특수학교,1,200,128,72,71,0,0,0
2020,경기,구리시,유치원,30,2107,1082,1025,173,0,0,0
2020,경기,구리시,초등학교,16,9738,5019,4719,616,201,108,93
2020,경기,구리시,중학교,8,4726,2545,2181,350,42,21,21
2020,경기,구리시,고등학교,7,4789,2449,2340,448,37,19,18
2020,경기,구리시,  (일반고),7,4789,2449,2340,448,37,19,18
2020,경기,구리시,각종학교,1,679,339,340,46,0,0,0
2020,경기,의정부시,유치원,63,4628,2316,2312,413,0,0,0
2020,경기,의정부시,초등학교,34,22170,11407,10763,1319,576,322,254
2020,경기,의정부시,중학교,19,11506,5944,5562,867,114,69,45
2020,경기,의정부시,고등학교,16,12031,6489,5542,1208,75,36,39
2020,경기,의정부시,  (일반고),12,9674,5114,4560,915,39,20,19
2020,경기,의정부시,  (특목고),1,274,218,56,53,1,1,0
2020,경기,의정부시,  (특성화고),3,2083,1157,926,240,35,15,20
2020,경기,의정부시,특수학교,2,225,153,72,82,0,0,0
2020,경기,파주시,유치원,95,6860,3454,3406,519,0,0,0
2020,경기,파주시,초등학교,58,29154,14871,14283,1847,871,447,424
2020,경기,파주시,중학교,26,13494,6853,6641,995,158,86,72
2020,경기,파주시,고등학교,18,12286,6257,6029,1054,78,43,35
2020,경기,파주시,  (일반고),15,10288,5133,5155,887,60,30,30
2020,경기,파주시,  (특성화고),2,917,673,244,84,18,13,5
2020,경기,파주시,  (자율고),1,1081,451,630,83,0,0,0
2020,경기,파주시,특수학교,2,334,231,103,131,0,0,0
2020,경기,동두천시,유치원,18,544,288,256,55,0,0,0
2020,경기,동두천시,초등학교,11,4787,2407,2380,309,314,151,163
2020,경기,동두천시,중학교,6,2415,1226,1189,202,98,47,51
2020,경기,동두천시,고등학교,6,2785,1362,1423,279,47,24,23
2020,경기,동두천시,  (일반고),4,1617,825,792,158,31,16,15
2020,경기,동두천시,  (특목고),1,598,196,402,61,5,1,4
2020,경기,동두천시,  (특성화고),1,570,341,229,60,11,7,4
2020,경기,양주시,유치원,47,2593,1302,1291,238,0,0,0
2020,경기,양주시,초등학교,34,13384,6723,6661,901,510,257,253
2020,경기,양주시,중학교,10,6376,3286,3090,460,119,65,54
2020,경기,양주시,고등학교,7,5229,2627,2602,424,52,25,27
2020,경기,양주시,  (일반고),5,4354,2157,2197,339,44,20,24
2020,경기,양주시,  (특성화고),1,325,137,188,31,7,4,3
2020,경기,양주시,  (자율고),1,550,333,217,54,1,1,0
2020,경기,양주시,특수학교,1,156,116,40,63,0,0,0
2020,경기,양주시,각종학교,1,177,104,73,17,4,2,2
2020,경기,포천시,유치원,33,906,484,422,91,0,0,0
2020,경기,포천시,초등학교,31,6334,3278,3056,570,488,233,255
2020,경기,포천시,중학교,14,3287,1756,1531,356,119,64,55
2020,경기,포천시,고등학교,7,3345,1796,1549,358,74,32,42
2020,경기,포천시,  (일반고),6,3192,1669,1523,334,74,32,42
2020,경기,포천시,  (특성화고),1,153,127,26,24,0,0,0
2020,경기,가평군,유치원,14,265,147,118,33,0,0,0
2020,경기,가평군,초등학교,13,2449,1233,1216,245,304,144,160
2020,경기,가평군,중학교,6,1542,760,782,144,106,56,50
2020,경기,가평군,고등학교,5,1481,799,682,164,100,56,44
2020,경기,가평군,  (일반고),4,1177,675,502,138,94,51,43
2020,경기,가평군,  (특목고),1,304,124,180,26,6,5,1
2020,경기,가평군,각종학교,1,12,0,12,5,2,0,2
2020,경기,연천군,유치원,13,393,187,206,39,0,0,0
2020,경기,연천군,초등학교,13,1702,875,827,205,128,69,59
2020,경기,연천군,중학교,6,841,460,381,123,45,31,14
2020,경기,연천군,고등학교,2,796,439,357,110,19,9,10
2020,경기,연천군,  (일반고),2,796,439,357,110,19,9,10
2020,경기,연천군,각종학교,1,14,0,14,5,1,0,1
